Report_Date,Open_Interest_All,MM_Long_All,MM_Short_All,Net_Position,Percent_of_OpenInterest
2006-06-13,1651025,217971,31383,186588,11.301
2006-06-20,1660431,188222,51725,136497,8.221
2006-06-27,1599046,192676,85370,107306,6.711
2006-07-03,1630673,215391,97802,117589,7.211
2006-07-11,1671220,227375,66799,160576,9.608
2006-07-18,1666137,224003,33658,190345,11.424
2006-07-25,1703133,220761,48723,172038,10.101
2006-08-01,1731018,231366,60325,171041,9.881
2006-08-08,1699740,223341,64325,159016,9.355
2006-08-15,1704444,193068,102958,90110,5.287
2006-08-22,1701840,197270,116636,80634,4.738
2006-08-29,1625725,210127,124710,85417,5.254
2006-09-05,1635746,215646,119073,96573,5.904
2006-09-12,1657493,197439,123342,74097,4.47
2006-09-19,1639081,210962,112747,98215,5.992
2006-09-26,1651672,235713,68384,167329,10.131
2006-10-03,1658557,244102,42973,201129,12.127
2006-10-10,1704664,245040,31242,213798,12.542
2006-10-17,1834478,262308,15053,247255,13.478
2006-10-24,1905066,252275,5706,246569,12.943
2006-10-31,1931056,257382,10796,246586,12.769
2006-11-07,2067296,272180,8757,263423,12.742
2006-11-14,2063733,278265,9119,269146,13.042
2006-11-21,1869504,281078,3699,277379,14.837
2006-11-28,1900334,272551,8695,263856,13.885
2006-12-05,1897803,264718,7326,257392,13.563
2006-12-12,1918795,275832,5907,269925,14.067
2006-12-19,1926939,278944,6884,272060,14.119
2006-12-26,1965459,279084,5072,274012,13.941
2007-01-03,1962900,267139,17174,249965,12.734
2007-01-09,1982035,250530,25492,225038,11.354
2007-01-16,2116104,286488,18411,268077,12.668
2007-01-23,2165406,294773,14604,280169,12.938
2007-01-30,2117734,290415,13644,276771,13.069
2007-02-06,2124616,284311,22482,261829,12.324
2007-02-13,2146315,312197,18390,293807,13.689
2007-02-20,2178460,320256,20202,300054,13.774
2007-02-27,2056876,312784,18728,294056,14.296
2007-03-06,2044698,290721,24978,265743,12.997
2007-03-13,2040518,257790,22401,235389,11.536
2007-03-20,2069720,249890,18172,231718,11.196
2007-03-27,2047064,240116,22564,217552,10.628
2007-04-03,2073836,176513,25588,150925,7.278
2007-04-10,2064809,183146,26099,157047,7.606
2007-04-17,2026793,186081,32170,153911,7.594
2007-04-24,1843103,194164,31655,162509,8.817
2007-05-01,1845252,212456,36681,175775,9.526
2007-05-08,1838949,201478,36476,165002,8.973
2007-05-15,1854647,204125,44602,159523,8.601
2007-05-22,1824437,193665,47510,146155,8.011
2007-05-29,1830297,190293,55403,134890,7.37
2007-06-05,1861219,209535,41117,168418,9.049
2007-06-12,1853611,217686,34436,183250,9.886
2007-06-19,1851543,248076,31551,216525,11.694
2007-06-26,1656375,211101,34843,176258,10.641
2007-07-03,1661833,199914,58813,141101,8.491
2007-07-10,1675341,211071,62878,148193,8.846
2007-07-17,1719601,197153,80089,117064,6.808
2007-07-24,1714010,191441,79328,112113,6.541
2007-07-31,1679356,193278,75389,117889,7.02
2007-08-07,1659771,190508,67036,123472,7.439
2007-08-14,1599397,182722,53070,129652,8.106
2007-08-21,1572036,184852,51792,133060,8.464
2007-08-28,1510757,186497,56256,130241,8.621
2007-09-04,1521929,176929,59424,117505,7.721
2007-09-11,1532637,178146,64064,114082,7.444
2007-09-18,1552246,184609,59806,124803,8.04
2007-09-25,1597369,207465,54514,152951,9.575
2007-10-02,1617964,201706,67841,133865,8.274
2007-10-09,1615276,179997,78228,101769,6.3
2007-10-16,1630952,184090,73648,110442,6.772
2007-10-23,1640585,187855,68210,119645,7.293
2007-10-30,1647761,194018,57277,136741,8.299
2007-11-06,1715094,224708,55987,168721,9.837
2007-11-13,1675679,215799,50134,165665,9.886
2007-11-20,1458168,228448,50820,177628,12.182
2007-11-27,1426948,218696,41012,177684,12.452
2007-12-04,1445029,232980,38767,194213,13.44
2007-12-11,1538786,246071,44890,201181,13.074
2007-12-18,1616549,263044,33521,229523,14.198
2007-12-24,1651670,279243,33223,246020,14.895
2007-12-31,1726038,288521,36163,252358,14.621
2008-01-08,1835417,300298,33720,266578,14.524
2008-01-15,1979178,300059,31177,268882,13.586
2008-01-22,1994131,301293,32701,268592,13.469
2008-01-29,2004859,289865,30535,259330,12.935
2008-02-05,2069386,304724,29574,275150,13.296
2008-02-12,2099426,303646,25677,277969,13.24
2008-02-19,2157730,311403,20766,290637,13.47
2008-02-26,2063360,309238,20324,288914,14.002
2008-03-04,2088241,308424,19163,289261,13.852
2008-03-11,2116928,297803,17739,280064,13.23
2008-03-18,2116132,261031,21618,239413,11.314
2008-03-25,2069835,227569,25167,202402,9.779
2008-04-01,2144353,219595,20745,198850,9.273
2008-04-08,2200149,246323,19938,226385,10.29
2008-04-15,2280549,266002,21996,244006,10.699
2008-04-22,2277500,263375,23699,239676,10.524
2008-04-29,2115380,263956,35035,228921,10.822
2008-05-06,2106567,275304,29415,245889,11.672
2008-05-13,2138015,269361,32778,236583,11.066
2008-05-20,2114083,264975,26789,238186,11.267
2008-05-27,2109630,259439,26246,233193,11.054
2008-06-03,2131857,255153,23918,231235,10.847
2008-06-10,2227228,290501,20122,270379,12.14
2008-06-17,2337654,276236,22259,253977,10.865
2008-06-24,2067462,268751,23933,244818,11.841
2008-07-01,2049965,263812,25403,238409,11.63
2008-07-08,2026074,236353,22734,213619,10.543
2008-07-15,2026276,217943,46711,171232,8.451
2008-07-22,2058725,199226,44580,154646,7.512
2008-07-29,1939753,193200,28087,165113,8.512
2008-08-05,1960640,180213,36281,143932,7.341
2008-08-12,1958525,171620,47571,124049,6.334
2008-08-19,1933672,174168,41046,133122,6.884
2008-08-26,1765382,164868,33778,131090,7.426
2008-09-02,1700368,156574,33316,123258,7.249
2008-09-09,1685113,148338,33062,115276,6.841
2008-09-16,1710581,139469,34191,105278,6.155
2008-09-23,1684482,143561,26665,116896,6.94
2008-09-30,1685800,130500,36321,94179,5.587
2008-10-07,1728906,121557,39260,82297,4.76
2008-10-14,1725221,107240,45361,61879,3.587
2008-10-21,1707036,100799,54962,45837,2.685
2008-10-28,1697112,103319,61606,41713,2.458
2008-11-04,1714300,99249,62622,36627,2.137
2008-11-11,1712370,93716,78013,15703,0.917
2008-11-18,1615398,90569,78781,11788,0.73
2008-11-25,1256683,89535,70036,19499,1.552
2008-12-02,1217149,87793,72867,14926,1.226
2008-12-09,1246848,89859,77058,12801,1.027
2008-12-16,1279967,94099,69393,24706,1.93
2008-12-22,1254797,89068,70370,18698,1.49
2008-12-30,1239047,91329,62535,28794,2.324
2009-01-06,1269024,94525,57307,37218,2.933
2009-01-13,1270167,92583,69438,23145,1.822
2009-01-20,1258263,96468,70241,26227,2.084
2009-01-27,1227531,91578,74741,16837,1.372
2009-02-03,1247816,95311,92949,2362,0.189
2009-02-10,1228466,97132,93837,3295,0.268
2009-02-17,1225572,92680,112686,-20006,1.632
2009-02-24,1091888,94338,115194,-20856,1.91
2009-03-03,1107615,91875,106218,-14343,1.295
2009-03-10,1119773,102368,85613,16755,1.496
2009-03-17,1160066,107554,57596,49958,4.306
2009-03-24,1195955,111822,51244,60578,5.065
2009-03-31,1224961,115075,54599,60476,4.937
2009-04-07,1251985,115687,54544,61143,4.884
2009-04-14,1245011,122478,61180,61298,4.923
2009-04-21,1234636,120610,101069,19541,1.583
2009-04-28,1164978,120769,105433,15336,1.316
2009-05-05,1175078,144947,83547,61400,5.225
2009-05-12,1264514,169935,60119,109816,8.684
2009-05-19,1294390,189793,46467,143326,11.073
2009-05-26,1329830,201452,45076,156376,11.759
2009-06-02,1412608,227192,52910,174282,12.338
2009-06-09,1412631,224725,42304,182421,12.914
2009-06-16,1395921,205507,55260,150247,10.763
2009-06-23,1388160,192502,82882,109620,7.897
2009-06-30,1277177,190884,87909,102975,8.063
2009-07-07,1291765,179878,99236,80642,6.243
2009-07-14,1298664,172816,112750,60066,4.625
2009-07-21,1356748,166371,123829,42542,3.136
2009-07-28,1308608,161779,117348,44431,3.395
2009-08-04,1313252,169740,96518,73222,5.576
2009-08-11,1330309,173176,93033,80143,6.024
2009-08-18,1321382,156653,105686,50967,3.857
2009-08-25,1267297,153848,118046,35802,2.825
2009-09-01,1262635,151764,126631,25133,1.991
2009-09-08,1272639,150852,133292,17560,1.38
2009-09-15,1316649,176174,110719,65455,4.971
2009-09-22,1345219,180911,110766,70145,5.214
2009-09-29,1313096,178803,85534,93269,7.103
2009-10-06,1377970,200184,68136,132048,9.583
2009-10-13,1411074,210868,42571,168297,11.927
2009-10-20,1448787,218845,29787,189058,13.049
2009-10-27,1435654,206991,26215,180776,12.592
2009-11-03,1422687,214694,18764,195930,13.772
2009-11-09,1473215,203831,17227,186604,12.666
2009-11-17,1502122,221438,17642,203796,13.567
2009-11-24,1214860,207140,23182,183958,15.142
2009-12-01,1220867,233327,20405,212922,17.44
2009-12-08,1218859,220730,43889,176841,14.509
2009-12-15,1212495,224321,28633,195688,16.139
2009-12-22,1220477,222614,32999,189615,15.536
2009-12-29,1247226,234239,28812,205427,16.471
2010-01-05,1299567,257495,28238,229257,17.641
2010-01-12,1384055,267441,37115,230326,16.641
2010-01-19,1410976,203278,72207,131071,9.289
2010-01-26,1435139,194510,99201,95309,6.641
2010-02-02,1476113,189413,113522,75891,5.141
2010-02-09,1481038,179046,138136,40910,2.762
2010-02-16,1513817,178733,137226,41507,2.742
2010-02-23,1385976,185406,120539,64867,4.68
2010-03-02,1390497,189891,101149,88742,6.382
2010-03-09,1423552,189749,103881,85868,6.032
2010-03-16,1445533,189033,133235,55798,3.86
2010-03-23,1483169,179827,150082,29745,2.006
2010-03-30,1520751,170022,163163,6859,0.451
2010-04-06,1522807,166990,185162,-18172,1.193
2010-04-13,1565172,171468,190712,-19244,1.23
2010-04-20,1576092,186255,176479,9776,0.62
2010-04-27,1490534,183998,183745,253,0.017
2010-05-04,1526170,202377,136880,65497,4.292
2010-05-11,1574996,212745,125487,87258,5.54
2010-05-18,1603124,215106,140961,74145,4.625
2010-05-25,1595631,207752,125851,81901,5.133
2010-06-01,1604392,209224,128481,80743,5.033
2010-06-08,1653962,199856,164330,35526,2.148
2010-06-15,1626988,212703,180075,32628,2.005
2010-06-22,1614651,205674,136461,69213,4.287
2010-06-29,1458113,184706,171661,13045,0.895
2010-07-06,1442318,202194,122445,79749,5.529
2010-07-13,1482277,242558,84491,158067,10.664
2010-07-20,1559644,261105,64443,196662,12.609
2010-07-27,1591725,271640,78192,193448,12.153
2010-08-03,1671881,307303,59304,247999,14.834
2010-08-10,1763632,339181,38153,301028,17.069
2010-08-17,1877911,365484,31681,333803,17.775
2010-08-24,1874004,373262,27903,345359,18.429
2010-08-31,1822805,399828,21291,378537,20.767
2010-09-07,1926178,419087,17203,401884,20.864
2010-09-14,1999764,427941,16091,411850,20.595
2010-09-21,2125837,425845,12753,413092,19.432
2010-09-28,2096043,441653,12464,429189,20.476
2010-10-05,2110788,414661,13535,401126,19.004
2010-10-12,2357123,421798,11359,410439,17.413
2010-10-19,2380072,426708,14113,412595,17.335
2010-10-26,2431281,423841,17398,406443,16.717
2010-11-02,2491349,429434,26900,402534,16.157
2010-11-09,2572723,422155,28666,393489,15.295
2010-11-16,2485904,379435,27508,351927,14.157
2010-11-23,2473822,366946,26228,340718,13.773
2010-11-30,2043404,358433,27145,331288,16.213
2010-12-07,2081663,366446,30557,335889,16.136
2010-12-14,2118708,390119,30893,359226,16.955
2010-12-21,2198012,411110,30415,380695,17.32
2010-12-28,2220581,425074,28292,396782,17.868
2011-01-04,2225065,400500,26501,373999,16.808
2011-01-11,2293704,397580,21606,375974,16.392
2011-01-18,2441969,434298,25444,408854,16.743
2011-01-25,2381171,409235,30121,379114,15.921
2011-02-01,2463395,427538,29382,398156,16.163
2011-02-08,2510643,428600,34072,394528,15.714
2011-02-15,2573509,414215,32993,381222,14.813
2011-02-22,2342713,403194,28667,374527,15.987
2011-03-01,2334568,407230,22407,384823,16.484
2011-03-08,2322358,382510,24199,358311,15.429
2011-03-15,2326505,333082,35686,297396,12.783
2011-03-22,2328827,313462,33811,279651,12.008
2011-03-29,2248933,317211,34392,282819,12.576
2011-04-05,2455167,359216,37147,322069,13.118
2011-04-12,2487515,378352,30729,347623,13.975
2011-04-19,2481319,395251,29803,365448,14.728
2011-04-26,2297491,391590,30236,361354,15.728
2011-05-03,2180458,365105,36270,328835,15.081
2011-05-10,2154362,340095,38093,302002,14.018
2011-05-17,2128708,333432,44393,289039,13.578
2011-05-24,2094720,341688,31158,310530,14.824
2011-05-31,2146889,356005,27893,328112,15.283
2011-06-07,2174051,347524,28436,319088,14.677
2011-06-14,2224832,362525,26104,336421,15.121
2011-06-21,2132924,306916,30554,276362,12.957
2011-06-28,1779907,262726,36594,226132,12.705
2011-07-05,1719396,234412,43595,190817,11.098
2011-07-12,1752002,250173,34106,216067,12.333
2011-07-19,1825618,277723,30598,247125,13.537
2011-07-26,1794304,277808,29236,248572,13.853
2011-08-02,1891929,296980,26853,270127,14.278
2011-08-09,1894620,286798,25957,260841,13.767
2011-08-16,1971299,309280,23302,285978,14.507
2011-08-23,2027276,315480,27361,288119,14.212
2011-08-30,1965600,354770,27454,327316,16.652
2011-09-06,1961734,357940,26590,331350,16.891
2011-09-13,1905262,331943,33610,298333,15.658
2011-09-20,1892130,281166,31189,249977,13.211
2011-09-27,1844339,247332,43463,203869,11.054
2011-10-04,1912911,217948,46614,171334,8.957
2011-10-11,1925148,220141,58824,161317,8.379
2011-10-18,1921134,223968,66064,157904,8.219
2011-10-25,1843331,236128,49006,187122,10.151
2011-11-01,1862592,248045,52768,195277,10.484
2011-11-08,1890003,263088,44091,218997,11.587
2011-11-15,1910946,254153,56526,197627,10.342
2011-11-22,1897477,223151,74067,149084,7.857
2011-11-29,1479265,217367,76350,141017,9.533
2011-12-06,1499287,221572,95927,125645,8.38
2011-12-13,1544339,232567,104901,127666,8.267
2011-12-20,1568094,232921,106460,126461,8.065
2011-12-27,1558918,238201,89548,148653,9.536
2012-01-03,1615568,253358,60858,192500,11.915
2012-01-10,1675585,277247,53495,223752,13.354
2012-01-17,1659403,252488,76179,176309,10.625
2012-01-24,1689901,258474,96647,161827,9.576
2012-01-31,1676757,276112,86066,190046,11.334
2012-02-07,1737986,294984,84900,210084,12.088
2012-02-14,1779030,293799,87746,206053,11.582
2012-02-21,1770174,276138,93189,182949,10.335
2012-02-28,1647928,294408,78720,215688,13.088
2012-03-06,1684032,300674,54537,246137,14.616
2012-03-13,1764358,306641,61314,245327,13.905
2012-03-20,1781170,310366,48675,261691,14.692
2012-03-27,1744273,291887,67330,224557,12.874
2012-04-03,1856305,287437,84635,202802,10.925
2012-04-10,1837252,280864,87032,193832,10.55
2012-04-17,1865114,254133,107543,146590,7.86
2012-04-24,1739626,238213,135134,103079,5.925
2012-05-01,1684519,240036,127708,112328,6.668
2012-05-08,1711083,233685,115362,118323,6.915
2012-05-15,1723037,218285,134618,83667,4.856
2012-05-22,1699747,203635,94613,109022,6.414
2012-05-29,1681497,179348,117855,61493,3.657
2012-06-05,1696371,179423,138086,41337,2.437
2012-06-12,1684295,177154,134130,43024,2.554
2012-06-19,1640692,194997,124282,70715,4.31
2012-06-26,1509075,191836,83294,108542,7.193
2012-07-03,1595468,208003,34820,173183,10.855
2012-07-10,1730417,230550,28594,201956,11.671
2012-07-17,1916920,254073,18476,235597,12.29
2012-07-24,2007418,288092,8707,279385,13.918
2012-07-31,1932495,291824,6439,285385,14.768
2012-08-07,1944758,298520,12558,285962,14.704
2012-08-14,1966851,317200,14022,303178,15.414
2012-08-21,2073500,355047,12154,342893,16.537
2012-08-28,1810958,335900,20487,315413,17.417
2012-09-04,1804347,343199,19570,323629,17.936
2012-09-11,1800348,320126,23659,296467,16.467
2012-09-18,1829734,305255,35093,270162,14.765
2012-09-25,1772923,295611,23556,272055,15.345
2012-10-02,1843335,297177,24451,272726,14.795
2012-10-09,1850087,286674,26208,260466,14.079
2012-10-16,1897016,286614,30053,256561,13.524
2012-10-23,1935194,309160,26311,282849,14.616
2012-10-30,1874753,279634,43252,236382,12.609
2012-11-06,1887427,280620,45182,235438,12.474
2012-11-13,1903443,256657,53804,202853,10.657
2012-11-20,1880049,281474,31246,250228,13.31
2012-11-27,1541817,290232,33145,257087,16.674
2012-12-04,1531416,315947,36937,279010,18.219
2012-12-11,1550240,278548,53010,225538,14.549
2012-12-18,1533350,248593,72962,175631,11.454
2012-12-24,1519198,227394,87285,140109,9.223
2012-12-31,1528736,220975,85069,135906,8.89
2013-01-08,1589423,218272,103159,115113,7.242
2013-01-15,1658310,242992,101143,141849,8.554
2013-01-22,1653458,248762,97255,151507,9.163
2013-01-29,1638105,260641,96207,164434,10.038
2013-02-05,1720772,285960,102993,182967,10.633
2013-02-12,1768034,244271,117908,126363,7.147
2013-02-19,1798722,220541,155238,65303,3.631
2013-02-26,1633637,218350,166275,52075,3.188
2013-03-05,1627540,225211,162347,62864,3.863
2013-03-12,1683071,235827,148156,87671,5.209
2013-03-19,1775631,272690,127155,145535,8.196
2013-03-26,1818556,308793,116232,192561,10.589
2013-04-02,1895395,250202,155887,94315,4.976
2013-04-09,1907259,223885,172908,50977,2.673
2013-04-16,1910349,225356,172968,52388,2.742
2013-04-23,1922177,209463,197224,12239,0.637
2013-04-30,1694481,216132,170635,45497,2.685
2013-05-07,1711663,221213,159581,61632,3.601
2013-05-14,1729183,234474,158842,75632,4.374
2013-05-21,1781563,244455,190003,54452,3.056
2013-05-28,1766679,265648,167268,98380,5.569
2013-06-04,1756977,258352,167404,90948,5.176
2013-06-11,1794071,253139,170622,82517,4.599
2013-06-18,1818654,255920,181515,74405,4.091
2013-06-25,1639001,256430,185729,70701,4.314
2013-07-02,1677959,218503,238446,-19943,1.189
2013-07-09,1677143,209900,265667,-55767,3.325
2013-07-16,1686068,218332,255594,-37262,2.21
2013-07-23,1797856,215397,298758,-83361,4.637
2013-07-30,1787673,206517,314606,-108089,6.046
2013-08-06,1851640,221413,334485,-113072,6.107
2013-08-13,1934066,220394,343615,-123221,6.371
2013-08-20,1871279,203378,295156,-91778,4.905
2013-08-27,1585788,200568,257996,-57428,3.621
2013-09-03,1578535,196120,260626,-64506,4.086
2013-09-10,1600221,197824,262510,-64686,4.042
2013-09-17,1664579,192063,296274,-104211,6.261
2013-09-24,1677801,192454,318799,-126345,7.53
2013-10-01,1755882,193452,345370,-151918,8.652
2013-10-08,1783725,190295,344942,-154647,8.67
2013-10-15,1811735,195690,349227,-153537,8.475
2013-10-22,1869789,197709,356951,-159242,8.517
2013-10-29,1902900,201994,382621,-180627,9.492
2013-11-05,1941041,206554,385274,-178720,9.207
2013-11-12,1945827,210488,349548,-139060,7.147
2013-11-19,2014849,210251,356337,-146086,7.25
2013-11-26,1557202,198118,339169,-141051,9.058
2013-12-03,1521559,203840,322654,-118814,7.809
2013-12-10,1536489,202863,295079,-92216,6.002
2013-12-17,1550962,200065,304910,-104845,6.76
2013-12-24,1524435,200091,287885,-87794,5.759
2013-12-31,1531779,198447,293259,-94812,6.19
2014-01-07,1563886,200220,291671,-91451,5.848
2014-01-14,1646323,214369,278300,-63931,3.883
2014-01-21,1680673,206868,266193,-59325,3.53
2014-01-28,1660475,203189,255306,-52117,3.139
2014-02-04,1686048,224130,229444,-5314,0.315
2014-02-11,1729744,231392,197052,34340,1.985
2014-02-18,1774313,235999,190747,45252,2.55
2014-02-25,1652554,252473,164957,87516,5.296
2014-03-04,1689545,270429,112307,158122,9.359
2014-03-11,1727031,289629,80068,209561,12.134
2014-03-18,1753857,297844,69984,227860,12.992
2014-03-25,1717075,307648,68361,239287,13.936
2014-04-01,1805037,321280,45444,275836,15.281
2014-04-08,1867590,317408,47271,270137,14.464
2014-04-15,1891052,303623,53120,250503,13.247
2014-04-22,1866548,293719,57084,236635,12.678
2014-04-29,1769753,320744,56353,264391,14.939
2014-05-06,1765891,323617,57138,266479,15.09
2014-05-13,1758862,320405,65361,255044,14.501
2014-05-20,1758904,288430,80858,207572,11.801
2014-05-27,1747759,282879,104560,178319,10.203
2014-06-03,1794142,296009,121849,174160,9.707
2014-06-10,1867880,294575,148139,146436,7.84
2014-06-17,1897919,303452,166172,137280,7.233
2014-06-24,1756425,310454,195278,115176,6.557
2014-07-01,1753310,300247,198059,102188,5.828
2014-07-08,1829445,307798,200198,107600,5.882
2014-07-15,1941894,294736,201635,93101,4.794
2014-07-22,2018482,287708,217300,70408,3.488
2014-07-29,2003405,301485,238461,63024,3.146
2014-08-05,2024097,319074,247386,71688,3.542
2014-08-12,2008552,321175,253510,67665,3.369
2014-08-19,1976604,318770,254051,64719,3.274
2014-08-26,1755681,324543,256950,67593,3.85
2014-09-02,1735823,332485,252369,80116,4.615
2014-09-09,1831840,328460,246994,81466,4.447
2014-09-16,1877009,329133,242088,87045,4.637
2014-09-23,1969520,322241,240705,81536,4.14
2014-09-30,1931406,332003,246917,85086,4.405
2014-10-07,1893351,332246,259153,73093,3.861
2014-10-14,1899171,325425,236757,88668,4.669
2014-10-21,1906785,323624,196672,126952,6.658
2014-10-28,1848632,305375,163587,141788,7.67
2014-11-04,1895470,304302,140629,163673,8.635
2014-11-11,1916672,302142,115335,186807,9.746
2014-11-18,1916328,302869,115915,186954,9.756
2014-11-25,1546770,311285,104089,207196,13.395
2014-12-02,1536954,307262,109923,197339,12.84
2014-12-09,1569234,317848,87654,230194,14.669
2014-12-16,1619574,311880,75710,236170,14.582
2014-12-23,1637415,308411,63989,244422,14.927
2014-12-30,1584175,308712,69008,239704,15.131
2015-01-06,1633720,308704,82069,226635,13.872
2015-01-13,1685156,299813,95202,204611,12.142
2015-01-20,1716624,296630,99612,197018,11.477
2015-01-27,1689411,275142,105225,169917,10.058
2015-02-03,1758303,261558,145701,115857,6.589
2015-02-10,1768289,237637,128324,109313,6.182
2015-02-17,1778873,233310,130541,102769,5.777
2015-02-24,1621404,227047,146856,80191,4.946
2015-03-03,1610985,210462,160269,50193,3.116
2015-03-10,1642332,205302,172642,32660,1.989
2015-03-17,1778928,201361,238391,-37030,2.082
2015-03-24,1806955,210622,209871,751,0.042
2015-03-31,1807763,197204,188651,8553,0.473
2015-04-07,1809465,192746,183655,9091,0.502
2015-04-14,1875432,182558,230870,-48312,2.576
2015-04-21,1851654,173809,239107,-65298,3.526
2015-04-28,1770937,190346,282729,-92383,5.217
2015-05-05,1817160,205145,322130,-116985,6.438
2015-05-12,1839894,222320,338900,-116580,6.336
2015-05-19,1899696,230992,365732,-134740,7.093
2015-05-26,1940073,236588,377031,-140443,7.239
2015-06-02,1967101,243527,378368,-134841,6.855
2015-06-09,1982262,246716,337289,-90573,4.569
2015-06-16,2015048,246955,367126,-120171,5.964
2015-06-23,1985010,245666,340188,-94522,4.762
2015-06-30,1872560,291529,220923,70606,3.771
2015-07-07,1892372,288542,115262,173280,9.157
2015-07-14,1953234,293372,90625,202747,10.38
2015-07-21,1975488,334088,54423,279665,14.157
2015-07-28,1867692,302594,59793,242801,13.0
2015-08-04,1917728,283371,119572,163799,8.541
2015-08-11,1938783,271129,170011,101118,5.216
2015-08-18,1912247,259802,186176,73626,3.85
2015-08-25,1685206,244006,170469,73537,4.364
2015-09-01,1641364,241494,164509,76985,4.69
2015-09-08,1682121,242547,195286,47261,2.81
2015-09-15,1700758,249800,180004,69796,4.104
2015-09-22,1726114,249623,182998,66625,3.86
2015-09-29,1720579,251827,184414,67413,3.918
2015-10-06,1734290,268718,150989,117729,6.788
2015-10-13,1698898,242931,150707,92224,5.428
2015-10-20,1731746,223910,191077,32833,1.896
2015-10-27,1699940,225978,192378,33600,1.977
2015-11-03,1742154,218405,193640,24765,1.422
2015-11-10,1841342,187511,245915,-58404,3.172
2015-11-17,1835757,172377,257040,-84663,4.612
2015-11-24,1569546,164118,263926,-99808,6.359
2015-12-01,1564356,175087,253227,-78140,4.995
2015-12-08,1555113,172487,237233,-64746,4.163
2015-12-15,1544832,168519,207625,-39106,2.531
2015-12-22,1586524,152914,235457,-82543,5.203
2015-12-29,1595753,153826,289937,-136111,8.53
2016-01-05,1664511,156263,318251,-161988,9.732
2016-01-12,1718119,153725,340556,-186831,10.874
2016-01-19,1725214,155584,313794,-158210,9.17
2016-01-26,1664876,154428,241625,-87197,5.237
2016-02-02,1690543,173472,232951,-59479,3.518
2016-02-09,1747003,165855,268640,-102785,5.884
2016-02-16,1749401,160192,298129,-137937,7.885
2016-02-23,1622002,160811,295145,-134334,8.282
2016-03-01,1630381,144629,348466,-203837,12.502
2016-03-08,1687116,145100,374276,-229176,13.584
2016-03-15,1714437,161903,350070,-188167,10.975
2016-03-22,1710319,168208,322777,-154569,9.037
2016-03-29,1699627,172210,280643,-108433,6.38
2016-04-05,1850969,156829,318694,-161865,8.745
2016-04-12,1886803,159873,296578,-136705,7.245
2016-04-19,1937677,185508,216417,-30909,1.595
2016-04-26,1850214,231735,151954,79781,4.312
2016-05-03,1811506,223937,152905,71032,3.921
2016-05-10,1787262,203239,160270,42969,2.404
2016-05-17,1828693,206525,157547,48978,2.678
2016-05-24,1840059,217372,152676,64696,3.516
2016-05-31,1866861,248107,117309,130798,7.006
2016-06-07,2006083,298346,90379,207967,10.367
2016-06-14,2088225,327599,75304,252295,12.082
2016-06-21,2045819,328923,104096,224827,10.99
2016-06-28,1770114,262634,87908,174726,9.871
2016-07-05,1788889,211963,108860,103103,5.764
2016-07-12,1805645,170469,161767,8702,0.482
2016-07-19,1826301,165322,178684,-13362,0.732
2016-07-26,1759784,151094,216632,-65538,3.724
2016-08-02,1812322,151843,256275,-104432,5.762
2016-08-09,1846059,153737,290814,-137077,7.425
2016-08-16,1885260,158267,319746,-161479,8.565
2016-08-23,1889384,177950,331892,-153942,8.148
2016-08-30,1708372,176163,338666,-162503,9.512
2016-09-06,1717881,173355,354248,-180893,10.53
2016-09-13,1698121,175692,322632,-146940,8.653
2016-09-20,1706158,177933,339525,-161592,9.471
2016-09-27,1707593,170340,347184,-176844,10.356
2016-10-04,1707470,180643,343501,-162858,9.538
2016-10-11,1705598,175974,306947,-130973,7.679
2016-10-18,1730859,194901,264879,-69978,4.043
2016-10-25,1724477,197392,266354,-68962,3.999
2016-11-01,1761458,203659,268667,-65008,3.691
2016-11-08,1751431,213658,241712,-28054,1.602
2016-11-15,1811606,180501,265657,-85156,4.701
2016-11-22,1757622,184624,245018,-60394,3.436
2016-11-29,1479941,183863,253124,-69261,4.68
2016-12-06,1482575,169279,241871,-72592,4.896
2016-12-13,1483182,167617,241624,-74007,4.99
2016-12-20,1494211,164525,261611,-97086,6.497
2016-12-27,1497392,163211,276859,-113648,7.59
2017-01-03,1525508,176652,273021,-96369,6.317
2017-01-10,1547164,186130,262694,-76564,4.949
2017-01-17,1649271,199428,250813,-51385,3.116
2017-01-24,1682765,242526,221628,20898,1.242
2017-01-31,1650586,229116,225655,3461,0.21
2017-02-07,1729810,247967,219134,28833,1.667
2017-02-14,1856434,281234,195874,85360,4.598
2017-02-21,1909551,280922,188706,92216,4.829
2017-02-28,1685712,268066,185931,82135,4.872
2017-03-07,1707744,274859,194778,80081,4.689
2017-03-14,1755380,210705,234307,-23602,1.345
2017-03-21,1818223,206815,288506,-81691,4.493
2017-03-28,1814115,193780,349292,-155512,8.572
2017-04-04,1854437,186797,337084,-150287,8.104
2017-04-11,1885245,194807,353224,-158417,8.403
2017-04-18,1902704,182590,354399,-171809,9.03
2017-04-25,1839080,190753,387010,-196257,10.671
2017-05-02,1756829,185081,369711,-184630,10.509
2017-05-09,1797779,183102,391744,-208642,11.606
2017-05-16,1809949,204196,408105,-203909,11.266
2017-05-23,1834218,209291,385794,-176503,9.623
2017-05-30,1797132,209318,410299,-200981,11.183
2017-06-06,1863218,242880,381638,-138758,7.447
2017-06-13,1923781,254414,272343,-17929,0.932
2017-06-20,1866228,244502,298327,-53825,2.884
2017-06-27,1729295,218697,324816,-106119,6.137
2017-07-03,1753868,222056,268771,-46715,2.664
2017-07-11,1840817,260080,159116,100964,5.485
2017-07-18,1807610,253267,148597,104670,5.791
2017-07-25,1758611,245691,138876,106815,6.074
2017-08-01,1800411,247450,162806,84644,4.701
2017-08-08,1767900,232044,164971,67073,3.794
2017-08-15,1792103,228705,188903,39802,2.221
2017-08-22,1874724,221765,238838,-17073,0.911
2017-08-29,1707700,213692,278637,-64945,3.803
2017-09-05,1675001,210368,320091,-109723,6.551
2017-09-12,1736940,214067,333479,-119412,6.875
2017-09-19,1785555,215566,350172,-134606,7.539
2017-09-26,1756920,217488,350930,-133442,7.595
2017-10-03,1804698,214312,357513,-143201,7.935
2017-10-10,1833377,210583,373520,-162937,8.887
2017-10-17,1869045,204834,375518,-170684,9.132
2017-10-24,1932939,207036,381430,-174394,9.022
2017-10-31,1970091,193958,396721,-202763,10.292
2017-11-07,2009799,202042,407666,-205624,10.231
2017-11-14,2127835,203814,434370,-230556,10.835
2017-11-21,2082562,214241,424707,-210466,10.106
2017-11-28,1856263,214942,411705,-196763,10.6
2017-12-05,1792019,228484,389003,-160519,8.957
2017-12-12,1836183,207182,404374,-197192,10.739
2017-12-19,1880411,207122,429275,-222153,11.814
2017-12-26,1852922,209616,416240,-206624,11.151
2018-01-02,1851952,210518,409094,-198576,10.723
2018-01-09,1915789,201438,423954,-222516,11.615
2018-01-16,1979732,211296,438172,-226876,11.46
2018-01-23,2038080,207898,427574,-219676,10.779
2018-01-30,2093775,239369,370311,-130942,6.254
2018-02-06,2132218,250148,333072,-82924,3.889
2018-02-13,2104949,258602,269216,-10614,0.504
2018-02-20,2128714,266270,247596,18674,0.877
2018-02-27,1986305,285058,225938,59120,2.976
2018-03-06,2149942,349582,186048,163534,7.606
2018-03-13,2323591,380552,147489,233063,10.03
2018-03-20,2310613,370555,157324,213231,9.228
2018-03-27,2315457,313238,196327,116911,5.049
2018-04-03,2403876,326893,186706,140187,5.832
2018-04-10,2448431,329989,155102,174887,7.143
2018-04-17,2382243,302072,163828,138244,5.803
2018-04-24,2259200,307162,184285,122877,5.439
2018-05-01,2318130,339128,152811,186317,8.037
2018-05-08,2362419,343355,131463,211892,8.969
2018-05-15,2406162,338307,146635,191672,7.966
2018-05-22,2488853,353430,153460,199970,8.035
2018-05-29,2511087,354067,151640,202427,8.061
2018-06-05,2558208,330382,216783,113599,4.441
2018-06-12,2566347,323123,286907,36216,1.411
2018-06-19,2635956,313633,327671,-14038,0.533
2018-06-26,2386393,307459,367778,-60319,2.528
2018-07-03,2360868,295137,365947,-70810,2.999
2018-07-10,2352719,280906,385282,-104376,4.436
2018-07-17,2409890,268103,397426,-129323,5.366
2018-07-24,2470639,277329,407526,-130197,5.27
2018-07-31,2369980,313213,365411,-52198,2.202
2018-08-07,2287244,287516,317221,-29705,1.299
2018-08-14,2227303,270190,295152,-24962,1.121
2018-08-21,2207245,267299,282123,-14824,0.672
2018-08-28,2049082,256961,313918,-56957,2.78
2018-09-04,2058661,275305,332189,-56884,2.763
2018-09-11,2085115,265515,328985,-63470,3.044
2018-09-18,2162153,237352,378628,-141276,6.534
2018-09-25,2127915,248399,361178,-112779,5.3
2018-10-02,2101050,247873,305637,-57764,2.749
2018-10-09,2069913,250237,284269,-34032,1.644
2018-10-16,2063836,253569,233415,20154,0.977
2018-10-23,2080617,252969,227588,25381,1.22
2018-10-30,2069827,243097,228828,14269,0.689
2018-11-06,2139071,247727,221098,26629,1.245
2018-11-13,2154088,238615,220634,17981,0.835
2018-11-20,2138019,219280,227125,-7845,0.367
2018-11-27,1918320,221361,243509,-22148,1.155
2018-12-04,1883246,275973,222228,53745,2.854
2018-12-11,1900969,277727,179110,98617,5.188
2018-12-18,1903441,293035,164858,128177,6.734
2018-12-24,1856868,271253,173441,97812,5.268
2018-12-31,1880756,255007,198941,56066,2.981
2019-01-08,1923679,265315,190121,75194,3.909
2019-01-15,1958642,242736,215277,27459,1.402
2019-01-22,1989188,240887,196529,44358,2.23
2019-01-29,2018548,215859,209598,6261,0.31
2019-02-05,2070787,226093,211723,14370,0.694
2019-02-12,2104872,230451,245144,-14693,0.698
2019-02-19,2145138,211462,297737,-86275,4.022
2019-02-26,1973341,224514,328973,-104459,5.294
2019-03-05,2011395,216988,393765,-176777,8.789
2019-03-12,2150365,204451,462416,-257965,11.996
2019-03-19,2223346,199328,460654,-261326,11.754
2019-03-26,2202441,201979,405393,-203414,9.236
2019-04-02,2217004,184886,431621,-246735,11.129
2019-04-09,2165129,181710,453456,-271746,12.551
2019-04-16,2233832,184184,491713,-307529,13.767
2019-04-23,2294839,184240,506455,-322215,14.041
2019-04-30,2025935,193669,500368,-306699,15.139
2019-05-07,2033686,199907,482234,-282327,13.883
2019-05-14,2117253,194694,477612,-282918,13.363
2019-05-21,2361019,225444,342173,-116729,4.944
2019-05-28,2495825,236138,256874,-20736,0.831
2019-06-04,2549467,240884,153641,87243,3.422
2019-06-11,2573005,243843,132631,111212,4.322
2019-06-18,2708872,254850,111335,143515,5.298
2019-06-25,2379990,284249,96320,187929,7.896
2019-07-02,2319482,284974,103326,181648,7.831
2019-07-09,2382235,289991,102823,187168,7.857
2019-07-16,2424021,284799,97539,187260,7.725
2019-07-23,2399315,267288,114072,153216,6.386
2019-07-30,2295213,246009,134057,111952,4.878
2019-08-06,2348072,228926,149419,79507,3.386
2019-08-13,2351921,210926,166413,44513,1.893
2019-08-20,2327438,180200,236641,-56441,2.425
2019-08-27,2032700,170237,264374,-94137,4.631
2019-09-03,1989742,167410,286781,-119371,5.999
2019-09-10,2075792,174226,310625,-136399,6.571
2019-09-17,2070638,162646,333272,-170626,8.24
2019-09-24,2012801,159766,319656,-159890,7.944
2019-10-01,2042308,166186,292360,-126174,6.178
2019-10-08,2110757,176471,267139,-90668,4.296
2019-10-15,2042653,150635,216776,-66141,3.238
2019-10-22,2073951,148360,224415,-76055,3.667
2019-10-29,2006474,138006,223343,-85337,4.253
2019-11-05,2034158,137874,242720,-104846,5.154
2019-11-12,2034354,136504,247425,-110921,5.452
2019-11-19,2073496,135595,259125,-123530,5.958
2019-11-26,1748799,139774,255846,-116072,6.637
2019-12-03,1713170,152538,237675,-85137,4.97
2019-12-10,1756437,142704,257505,-114801,6.536
2019-12-17,1800803,158395,253232,-94837,5.266
2019-12-24,1787533,152453,237359,-84906,4.75
2019-12-31,1756379,159208,241664,-82456,4.695
2020-01-07,1783463,157761,238648,-80887,4.535
2020-01-14,1873406,179389,257831,-78442,4.187
2020-01-21,1851616,183375,251179,-67804,3.662
2020-01-28,1823044,186496,215972,-29476,1.617
2020-02-04,1864295,173461,229451,-55990,3.003
2020-02-11,1868556,168306,240390,-72084,3.858
2020-02-18,1901283,190221,251682,-61461,3.233
2020-02-25,1815443,204092,299602,-95510,5.261
2020-03-03,1764525,201870,286809,-84939,4.814
2020-03-10,1753106,196437,256807,-60370,3.444
2020-03-17,1781773,153753,245599,-91846,5.155
2020-03-24,1747679,134490,243039,-108549,6.211
2020-03-31,1717093,120739,221071,-100332,5.843
2020-04-07,1798814,122282,232684,-110402,6.137
2020-04-14,1829281,120405,257976,-137571,7.52
2020-04-21,1908967,125741,286798,-161057,8.437
2020-04-28,1789803,126858,287833,-160975,8.994
2020-05-05,1775306,117954,308106,-190152,10.711
2020-05-12,1814501,114201,328255,-214054,11.797
2020-05-19,1834951,116817,362203,-245386,13.373
2020-05-26,1840617,115486,391689,-276203,15.006
2020-06-02,1905933,121694,403960,-282266,14.81
2020-06-09,1938786,124084,421396,-297312,15.335
2020-06-16,2012716,135700,406451,-270751,13.452
2020-06-23,2034732,140864,418343,-277479,13.637
2020-06-30,1926269,165053,366701,-201648,10.468
2020-07-07,1872744,157038,298779,-141741,7.569
2020-07-14,1876486,157382,291007,-133625,7.121
2020-07-21,1905548,157217,294987,-137770,7.23
2020-07-28,1950332,166272,309552,-143280,7.346
2020-08-04,2030923,179706,352526,-172820,8.509
2020-08-11,1990550,176758,349119,-172361,8.659
2020-08-18,1936499,188672,299171,-110499,5.706
2020-08-25,1730455,189211,250700,-61489,3.553
2020-09-01,1722881,196470,177811,18659,1.083
2020-09-08,1751115,189407,155913,33494,1.913
2020-09-15,1837646,199134,140578,58556,3.186
2020-09-22,1912306,215261,119349,95912,5.016
2020-09-29,1879842,216683,109863,106820,5.682
2020-10-06,1974057,226790,92324,134466,6.812
2020-10-13,2004401,246179,75310,170869,8.525
2020-10-20,2150651,278859,60034,218825,10.175
2020-10-27,2157487,319864,43629,276235,12.804
2020-11-03,2188941,325054,34974,290080,13.252
2020-11-10,2325019,331943,51108,280835,12.079
2020-11-17,2343213,332177,53288,278889,11.902
2020-11-24,2136443,344084,56485,287599,13.462
2020-12-01,2078871,334643,64010,270633,13.018
2020-12-08,2089840,341250,71667,269583,12.9
2020-12-15,2117529,330412,80152,250260,11.818
2020-12-21,2191529,338920,73207,265713,12.125
2020-12-29,2243733,397762,65717,332045,14.799
2021-01-05,2379202,409156,59268,349888,14.706
2021-01-12,2580675,430896,56182,374714,14.52
2021-01-19,2609505,387294,37799,349495,13.393
2021-01-26,2574864,397449,33220,364229,14.146
2021-02-02,2639800,374487,29340,345147,13.075
2021-02-09,2693387,387234,28427,358807,13.322
2021-02-16,2664969,395075,29290,365785,13.726
2021-02-23,2462699,388302,27151,361151,14.665
2021-03-02,2358552,379406,30860,348546,14.778
2021-03-09,2374719,389756,33242,356514,15.013
2021-03-16,2389663,399452,28552,370900,15.521
2021-03-23,2341060,416963,28788,388175,16.581
2021-03-30,2320111,425822,30238,395584,17.05
2021-04-06,2364959,413094,26475,386619,16.348
2021-04-13,2448675,428954,26961,401993,16.417
2021-04-20,2547704,414821,30823,383998,15.072
2021-04-27,2399229,407085,28422,378663,15.783
2021-05-04,2438342,395732,23184,372548,15.279
2021-05-11,2557937,344039,27703,316336,12.367
2021-05-18,2493255,326504,35479,291025,11.672
2021-05-25,2433267,307277,39186,268091,11.018
2021-06-01,2527672,317219,27283,289936,11.47
2021-06-08,2559044,308518,32919,275599,10.77
2021-06-15,2538875,288661,35931,252730,9.954
2021-06-22,2414293,273265,29800,243465,10.084
2021-06-29,2063095,277442,32008,245434,11.896
2021-07-06,2095646,268938,49567,219371,10.468
2021-07-13,2055274,253104,44305,208799,10.159
2021-07-20,2063723,262463,39161,223302,10.82
2021-07-27,1976722,261685,33676,228009,11.535
2021-08-03,1992118,275002,28502,246500,12.374
2021-08-10,1973657,283457,29413,254044,12.872
2021-08-17,1989268,301051,22140,278911,14.021
2021-08-24,1985043,297686,26692,270994,13.652
2021-08-31,1806045,290205,31420,258785,14.329
2021-09-07,1824181,266717,51545,215172,11.796
2021-09-14,1819484,257697,45468,212229,11.664
2021-09-21,1825578,255464,41114,214350,11.741
2021-09-28,1824772,275176,30435,244741,13.412
2021-10-05,1826338,285156,34560,250596,13.721
2021-10-12,1830438,278361,50430,227931,12.452
2021-10-19,1830900,266344,46776,219568,11.992
2021-10-26,1880818,277195,32405,244790,13.015
2021-11-02,1988278,350148,25588,324560,16.324
2021-11-09,2002111,348003,28394,319609,15.964
2021-11-16,2075468,366930,25795,341135,16.437
2021-11-23,2099574,389868,23177,366691,17.465
2021-11-30,1681394,351592,36323,315269,18.75
2021-12-07,1724182,358318,25817,332501,19.285
2021-12-14,1757032,371134,25154,345980,19.691
2021-12-21,1801189,385219,24803,360416,20.01
2021-12-28,1843102,399264,25919,373345,20.256
2022-01-04,1865691,390165,24260,365905,19.612
2022-01-11,1861529,374917,30538,344379,18.5
2022-01-18,1828316,359364,32841,326523,17.859
2022-01-25,1903794,395086,29481,365605,19.204
2022-02-01,1979521,403360,30809,372551,18.82
2022-02-08,1998012,375456,38124,337332,16.883
2022-02-15,2062677,362876,37362,325514,15.781
2022-02-22,1947320,388162,33726,354436,18.201
2022-03-01,1977728,370463,21241,349222,17.658
2022-03-08,2054595,379149,10365,368784,17.949
2022-03-15,2083011,381282,8373,372909,17.902
2022-03-22,2149285,391467,7366,384101,17.871
2022-03-29,2062031,366925,12321,354604,17.197
2022-04-05,2170866,371413,9107,362306,16.689
2022-04-12,2263395,379808,9856,369952,16.345
2022-04-19,2363241,390912,11802,379110,16.042
2022-04-26,2157559,377761,17106,360655,16.716
2022-05-03,2172898,382981,29463,353518,16.269
2022-05-10,2168588,375782,37220,338562,15.612
2022-05-17,2256288,386154,46443,339711,15.056
2022-05-24,2188145,355178,63709,291469,13.32
2022-05-31,2212940,342234,73270,268964,12.154
2022-06-07,2217675,322819,58492,264327,11.919
2022-06-14,2214773,329725,51540,278185,12.56
2022-06-21,2199804,312919,47655,265264,12.059
2022-06-28,1855971,274734,46119,228615,12.318
2022-07-05,1854508,244288,71421,172867,9.321
2022-07-12,1906814,227316,76142,151174,7.928
2022-07-19,1878222,202400,77097,125303,6.671
2022-07-26,1812824,198577,77789,120788,6.663
2022-08-02,1835694,204893,74972,129921,7.077
2022-08-09,1803434,216192,74130,142062,7.877
2022-08-16,1803247,230808,76968,153840,8.531
2022-08-23,1848801,238757,56541,182216,9.856
2022-08-30,1716908,269203,47736,221467,12.899
2022-09-06,1730634,271592,45113,226479,13.086
2022-09-13,1792121,287203,46560,240643,13.428
2022-09-20,1817528,293911,46002,247909,13.64
2022-09-27,1787424,275027,37173,237854,13.307
2022-10-04,1829430,272037,28309,243728,13.323
2022-10-11,1886410,300720,33343,267377,14.174
2022-10-18,1856288,293795,39534,254261,13.697
2022-10-25,1862587,308116,43742,264374,14.194
2022-11-01,1916119,314305,42345,271960,14.193
2022-11-08,1920077,293161,55499,237662,12.378
2022-11-15,1851206,236231,59400,176831,9.552
2022-11-22,1766134,225645,54878,170767,9.669
2022-11-29,1453268,239602,47971,191631,13.186
2022-12-06,1486178,196674,76461,120213,8.089
2022-12-13,1457563,192443,65337,127106,8.72
2022-12-20,1443655,180236,66421,113815,7.884
2022-12-27,1423239,214313,54998,159315,11.194
2023-01-03,1469933,243553,47096,196457,13.365
2023-01-10,1481932,211823,62218,149605,10.095
2023-01-17,1552011,253836,61699,192137,12.38
2023-01-24,1587621,266783,64986,201797,12.711
2023-01-31,1602455,285287,65363,219924,13.724
2023-02-07,1622738,285344,83326,202018,12.449
2023-02-14,1685824,309315,74450,234865,13.932
2023-02-21,1647324,292316,76388,215928,13.108
2023-02-28,1522958,211877,143242,68635,4.507
2023-03-07,1564601,196623,175565,21058,1.346
2023-03-14,1667603,170239,224373,-54134,3.246
2023-03-21,1690830,179032,220928,-41896,2.478
2023-03-28,1670838,186529,199817,-13288,0.795
2023-04-04,1670937,199558,178011,21547,1.29
2023-04-11,1681027,213491,186379,27112,1.613
2023-04-18,1690262,220716,171282,49434,2.925
2023-04-25,1569537,190680,205977,-15297,0.975
2023-05-02,1619667,152174,270320,-118146,7.294
2023-05-09,1680175,159467,269110,-109643,6.526
2023-05-16,1754792,171753,263738,-91985,5.242
2023-05-23,1774459,171893,269920,-98027,5.524
2023-05-30,1761882,171723,222788,-51065,2.898
2023-06-06,1785372,163444,207936,-44492,2.492
2023-06-13,1775421,166551,164406,2145,0.121
2023-06-20,1876435,198770,140471,58299,3.107
2023-06-27,1691668,184877,132032,52845,3.124
2023-07-03,1773049,159968,178177,-18209,1.027
2023-07-11,1754033,151163,214215,-63052,3.595
2023-07-18,1795710,145064,191990,-46926,2.613
2023-07-25,1746270,169819,143216,26603,1.523
2023-08-01,1790636,185022,168281,16741,0.935
2023-08-08,1766694,175092,201748,-26656,1.509
2023-08-15,1801252,165058,237638,-72580,4.029
2023-08-22,1811682,155810,261945,-106135,5.858
2023-08-29,1582086,166472,253820,-87348,5.521
2023-09-05,1604578,174807,268720,-93913,5.853
2023-09-12,1665919,159875,294784,-134909,8.098
2023-09-19,1676086,165227,310042,-144815,8.64
2023-09-26,1691972,163209,331815,-168606,9.965
2023-10-03,1724511,163723,323156,-159433,9.245
2023-10-10,1734458,173856,286547,-112691,6.497
2023-10-17,1737540,175267,284137,-108870,6.266
2023-10-24,1788615,170014,270444,-100430,5.615
2023-10-31,1775914,159394,303826,-144432,8.133
2023-11-07,1830388,147264,315852,-168588,9.211
2023-11-14,1837197,153860,317346,-163486,8.899
2023-11-21,1809415,152421,337923,-185502,10.252
2023-11-28,1524237,156059,362537,-206478,13.546
2023-12-05,1505781,175928,336461,-160533,10.661
2023-12-12,1504457,173618,325188,-151570,10.075
2023-12-19,1541649,170664,351388,-180724,11.723
2023-12-26,1533323,173080,350706,-177626,11.584
2024-01-02,1601347,162354,359680,-197326,12.323
2024-01-09,1713898,157714,388437,-230723,13.462
2024-01-16,1852331,155283,415825,-260542,14.066
2024-01-23,1958230,158243,423528,-265285,13.547
2024-01-30,1963831,162210,442361,-280151,14.266
2024-02-06,1995994,168825,466569,-297744,14.917
2024-02-13,2038849,174846,489187,-314341,15.418
2024-02-20,2053885,164365,505097,-340732,16.59
2024-02-27,1896360,174399,469657,-295258,15.57
2024-03-05,1914649,173777,470572,-296795,15.501
2024-03-12,1961433,177057,432985,-255928,13.048
2024-03-19,1999136,171123,414111,-242988,12.155
2024-03-26,2017822,174131,425861,-251730,12.475
2024-04-02,2056525,170433,429989,-259556,12.621
2024-04-09,1999925,158480,422034,-263554,13.178
2024-04-16,1966208,161576,441146,-279570,14.219
2024-04-23,1969357,170215,408761,-238546,12.113
2024-04-30,1805673,176044,394084,-218040,12.075
2024-05-07,1895082,202149,304662,-102513,5.409
2024-05-14,1973804,218607,289778,-71171,3.606
2024-05-21,1993404,207971,329133,-121162,6.078
2024-05-28,1963843,213883,347360,-133477,6.797
2024-06-04,2067099,204160,416866,-212706,10.29
2024-06-11,2057510,207752,420031,-212279,10.317
