Report_Date,Open_Interest_All,MM_Long_All,MM_Short_All,Net_Position,Percent_of_OpenInterest
2006-06-13,201077,18205,24234,-6029,2.998
2006-06-20,191263,14897,22329,-7432,3.886
2006-06-27,197286,12064,31416,-19352,9.809
2006-07-03,198744,14444,29290,-14846,7.47
2006-07-11,201955,15692,32586,-16894,8.365
2006-07-18,224584,15573,46643,-31070,13.834
2006-07-25,223029,16447,49433,-32986,14.79
2006-08-01,236932,14315,56029,-41714,17.606
2006-08-08,246157,15596,60731,-45135,18.336
2006-08-15,253540,14437,60762,-46325,18.271
2006-08-22,264917,13884,64605,-50721,19.146
2006-08-29,257179,13353,62356,-49003,19.054
2006-09-05,260297,14865,59156,-44291,17.016
2006-09-12,274243,12911,68126,-55215,20.134
2006-09-19,265883,14239,57608,-43369,16.311
2006-09-26,242971,13284,49947,-36663,15.089
2006-10-03,236995,12348,50329,-37981,16.026
2006-10-10,229892,14075,44118,-30043,13.068
2006-10-17,222487,17723,28482,-10759,4.836
2006-10-24,225422,20550,24590,-4040,1.792
2006-10-31,233442,30976,18591,12385,5.305
2006-11-07,245096,35489,13162,22327,9.109
2006-11-14,241080,37321,13860,23461,9.732
2006-11-21,227001,35305,14032,21273,9.371
2006-11-28,233777,36111,14417,21694,9.28
2006-12-05,226476,28358,17623,10735,4.74
2006-12-12,226162,26679,14939,11740,5.191
2006-12-19,225546,22568,16524,6044,2.68
2006-12-26,212641,23773,16337,7436,3.497
2007-01-03,206889,26112,18181,7931,3.833
2007-01-09,206766,23049,18098,4951,2.394
2007-01-16,215860,31123,15383,15740,7.292
2007-01-23,228105,40587,13556,27031,11.85
2007-01-30,237717,43254,15872,27382,11.519
2007-02-06,242641,46501,12329,34172,14.083
2007-02-13,253793,59490,9110,50380,19.851
2007-02-20,263665,65260,8912,56348,21.371
2007-02-27,253982,60168,8154,52014,20.479
2007-03-06,238098,47983,9910,38073,15.99
2007-03-13,236946,44089,11467,32622,13.768
2007-03-20,237675,41414,11798,29616,12.461
2007-03-27,231854,36836,14010,22826,9.845
2007-04-03,237773,33328,14347,18981,7.983
2007-04-10,246790,30255,15400,14855,6.019
2007-04-17,247257,27096,16459,10637,4.302
2007-04-24,234577,23485,14111,9374,3.996
2007-05-01,234024,29937,16083,13854,5.92
2007-05-08,238972,28426,18780,9646,4.036
2007-05-15,239517,29303,19090,10213,4.264
2007-05-22,232978,33242,16342,16900,7.254
2007-05-29,233781,35295,14878,20417,8.733
2007-06-05,245743,44018,13071,30947,12.593
2007-06-12,246137,46175,9354,36821,14.96
2007-06-19,247226,50736,10673,40063,16.205
2007-06-26,224552,44869,9173,35696,15.897
2007-07-03,225492,48428,6449,41979,18.617
2007-07-10,234937,54127,5185,48942,20.832
2007-07-17,233191,54382,4540,49842,21.374
2007-07-24,224186,43735,5732,38003,16.952
2007-07-31,216417,39611,10614,28997,13.399
2007-08-07,220339,44253,9684,34569,15.689
2007-08-14,217119,43873,4916,38957,17.943
2007-08-21,211512,37546,4718,32828,15.521
2007-08-28,213327,43742,2188,41554,19.479
2007-09-04,222374,50214,1920,48294,21.717
2007-09-11,229688,52485,1399,51086,22.241
2007-09-18,246249,59436,2586,56850,23.086
2007-09-25,245826,59128,1844,57284,23.303
2007-10-02,235348,56956,4297,52659,22.375
2007-10-09,236629,54818,3024,51794,21.888
2007-10-16,246135,59163,3060,56103,22.794
2007-10-23,257147,61558,2823,58735,22.841
2007-10-30,259032,61514,1242,60272,23.268
2007-11-06,272461,67845,1489,66356,24.354
2007-11-13,271446,69050,4024,65026,23.955
2007-11-20,267814,68289,4656,63633,23.76
2007-11-27,262419,67490,5228,62262,23.726
2007-12-04,265907,71139,2897,68242,25.664
2007-12-11,273359,76671,1234,75437,27.596
2007-12-18,282010,75110,4830,70280,24.921
2007-12-24,277461,73335,4547,68788,24.792
2007-12-31,265428,67273,4495,62778,23.652
2008-01-08,256025,65703,2954,62749,24.509
2008-01-15,266205,60182,5826,54356,20.419
2008-01-22,269069,52738,8015,44723,16.621
2008-01-29,269258,46046,8345,37701,14.002
2008-02-05,268161,46908,7806,39102,14.582
2008-02-12,270010,47679,8889,38790,14.366
2008-02-19,269766,48901,7819,41082,15.229
2008-02-26,272634,50700,6487,44213,16.217
2008-03-04,269485,51562,4655,46907,17.406
2008-03-11,257290,36754,5424,31330,12.177
2008-03-18,255117,31452,10395,21057,8.254
2008-03-25,253447,27073,11325,15748,6.214
2008-04-01,258298,31693,6681,25012,9.683
2008-04-08,256508,30925,6250,24675,9.62
2008-04-15,251581,33246,5647,27599,10.97
2008-04-22,253695,36334,7798,28536,11.248
2008-04-29,237457,32837,9632,23205,9.772
2008-05-06,227040,32488,6330,26158,11.521
2008-05-13,224080,35493,6317,29176,13.02
2008-05-20,227259,31723,4481,27242,11.987
2008-05-27,226749,33467,4541,28926,12.757
2008-06-03,229375,36205,4132,32073,13.983
2008-06-10,237204,41402,3064,38338,16.162
2008-06-17,258011,51770,2237,49533,19.198
2008-06-24,245244,55538,2363,53175,21.682
2008-07-01,252731,54854,2222,52632,20.825
2008-07-08,248842,49674,3681,45993,18.483
2008-07-15,248332,48563,3230,45333,18.255
2008-07-22,231748,39375,8226,31149,13.441
2008-07-29,209604,32418,2747,29671,14.156
2008-08-05,212919,31163,3496,27667,12.994
2008-08-12,210028,26297,3062,23235,11.063
2008-08-19,201944,24894,2550,22344,11.064
2008-08-26,194596,28818,1797,27021,13.886
2008-09-02,193722,29148,2179,26969,13.921
2008-09-09,196382,25596,5264,20332,10.353
2008-09-16,194064,22992,7308,15684,8.082
2008-09-23,185840,21951,5365,16586,8.925
2008-09-30,181634,20779,9393,11386,6.269
2008-10-07,186640,19003,12820,6183,3.313
2008-10-14,188356,14883,12673,2210,1.173
2008-10-21,194116,14695,11953,2742,1.413
2008-10-28,186507,14410,8622,5788,3.103
2008-11-04,181888,12628,9068,3560,1.957
2008-11-11,173536,11902,8260,3642,2.099
2008-11-18,171840,10392,7230,3162,1.84
2008-11-25,148352,10611,6736,3875,2.612
2008-12-02,143368,9138,8753,385,0.269
2008-12-09,142327,9345,10349,-1004,0.705
2008-12-16,141451,10191,9477,714,0.505
2008-12-22,139650,11246,9153,2093,1.499
2008-12-30,132666,12970,5302,7668,5.78
2009-01-06,135183,14663,6097,8566,6.337
2009-01-13,134946,15732,5566,10166,7.533
2009-01-20,138180,16150,4318,11832,8.563
2009-01-27,146117,20023,2640,17383,11.897
2009-02-03,150542,20745,3039,17706,11.762
2009-02-10,149943,21225,3002,18223,12.153
2009-02-17,143787,16246,4438,11808,8.212
2009-02-24,129294,13025,7651,5374,4.156
2009-03-03,129705,14400,10588,3812,2.939
2009-03-10,124178,16593,11853,4740,3.817
2009-03-17,125278,18288,7812,10476,8.362
2009-03-24,129749,21838,4793,17045,13.137
2009-03-31,126448,22411,3998,18413,14.562
2009-04-07,132363,22868,6007,16861,12.738
2009-04-14,140410,28645,4278,24367,17.354
2009-04-21,151754,38414,4041,34373,22.65
2009-04-28,147616,36005,3612,32393,21.944
2009-05-05,163069,44278,1715,42563,26.101
2009-05-12,173458,43482,2783,40699,23.463
2009-05-19,195351,49757,1461,48296,24.723
2009-05-26,210179,55419,1619,53800,25.597
2009-06-02,217520,57680,1143,56537,25.992
2009-06-09,230949,57770,1018,56752,24.573
2009-06-16,230362,56914,838,56076,24.343
2009-06-23,219819,49304,1441,47863,21.774
2009-06-30,207297,49332,1683,47649,22.986
2009-07-07,203640,40453,4520,35933,17.645
2009-07-14,197483,33847,6038,27809,14.082
2009-07-21,195806,32579,4899,27680,14.136
2009-07-28,196856,36576,3866,32710,16.616
2009-08-04,201754,41952,1994,39958,19.805
2009-08-11,202771,45746,2932,42814,21.114
2009-08-18,188898,40207,3774,36433,19.287
2009-08-25,182479,39547,1741,37806,20.718
2009-09-01,178427,39885,2386,37499,21.016
2009-09-08,177601,36370,4317,32053,18.048
2009-09-15,184224,37919,2834,35085,19.045
2009-09-22,177893,34141,4200,29941,16.831
2009-09-29,170629,34394,3227,31167,18.266
2009-10-06,172182,34668,6577,28091,16.315
2009-10-13,173769,42207,7781,34426,19.811
2009-10-20,171954,40722,7752,32970,19.174
2009-10-27,171630,37329,8973,28356,16.522
2009-11-03,178582,40313,3097,37216,20.84
2009-11-09,177437,37884,5971,31913,17.986
2009-11-17,187729,41197,7475,33722,17.963
2009-11-24,186533,49046,6201,42845,22.969
2009-12-01,183463,52694,7115,45579,24.844
2009-12-08,181375,52313,10057,42256,23.298
2009-12-15,195146,55905,11604,44301,22.701
2009-12-22,187818,46665,11685,34980,18.624
2009-12-29,177304,46370,10784,35586,20.071
2010-01-05,183795,52017,10910,41107,22.366
2010-01-12,185815,48683,12079,36604,19.699
2010-01-19,189823,46025,10230,35795,18.857
2010-01-26,199811,48118,13779,34339,17.186
2010-02-02,211321,44265,19043,25222,11.935
2010-02-09,229359,42980,23370,19610,8.55
2010-02-16,231600,45323,22459,22864,9.872
2010-02-23,224551,46542,17721,28821,12.835
2010-03-02,221388,43976,20600,23376,10.559
2010-03-09,229233,40258,29226,11032,4.813
2010-03-16,233782,42039,29414,12625,5.4
2010-03-23,225957,42644,21124,21520,9.524
2010-03-30,228728,46886,15537,31349,13.706
2010-04-06,220517,45039,19275,25764,11.683
2010-04-13,224132,44870,19593,25277,11.278
2010-04-20,241328,50685,16337,34348,14.233
2010-04-27,221547,58388,8483,49905,22.526
2010-05-04,216224,62533,11481,51052,23.611
2010-05-11,207165,53574,10315,43259,20.881
2010-05-18,200910,47271,8707,38564,19.195
2010-05-25,195487,40353,6750,33603,17.189
2010-06-01,192248,39516,7254,32262,16.781
2010-06-08,197731,42307,3630,38677,19.56
2010-06-15,214638,54935,6377,48558,22.623
2010-06-22,227092,59297,8245,51052,22.481
2010-06-29,212042,62341,7020,55321,26.09
2010-07-06,210512,56160,8006,48154,22.875
2010-07-13,219145,65839,4113,61726,28.167
2010-07-20,229129,69725,7566,62159,27.128
2010-07-27,215673,68721,6098,62623,29.036
2010-08-03,215277,71229,5649,65580,30.463
2010-08-10,222805,73125,5927,67198,30.16
2010-08-17,233051,77474,6185,71289,30.589
2010-08-24,228579,72157,4980,67177,29.389
2010-08-31,234433,79980,7571,72409,30.887
2010-09-07,241088,80944,7629,73315,30.41
2010-09-14,233291,71717,5560,66157,28.358
2010-09-21,246697,77419,6111,71308,28.905
2010-09-28,239829,74186,8047,66139,27.578
2010-10-05,221179,56945,11214,45731,20.676
2010-10-12,233016,56659,10043,46616,20.005
2010-10-19,241723,56856,10353,46503,19.238
2010-10-26,244638,52855,9254,43601,17.823
2010-11-02,248875,52783,10499,42284,16.99
2010-11-09,251173,51656,4858,46798,18.632
2010-11-16,244567,40946,6901,34045,13.921
2010-11-23,256737,42497,7700,34797,13.554
2010-11-30,227793,41557,8003,33554,14.73
2010-12-07,228589,42166,9267,32899,14.392
2010-12-14,228335,41611,9687,31924,13.981
2010-12-21,231389,47495,8841,38654,16.705
2010-12-28,232577,48956,8827,40129,17.254
2011-01-04,227659,49576,8571,41005,18.012
2011-01-11,233313,49952,8951,41001,17.573
2011-01-18,251314,51056,7811,43245,17.208
2011-01-25,251553,50559,10449,40110,15.945
2011-02-01,262275,54805,9366,45439,17.325
2011-02-08,265189,54292,10233,44059,16.614
2011-02-15,263524,48090,13430,34660,13.153
2011-02-22,241659,42773,17895,24878,10.295
2011-03-01,245781,40039,18095,21944,8.928
2011-03-08,250287,36487,17041,19446,7.769
2011-03-15,254072,36344,19701,16643,6.551
2011-03-22,253049,44314,17497,26817,10.598
2011-03-29,251646,43214,18532,24682,9.808
2011-04-05,256611,42976,21313,21663,8.442
2011-04-12,259923,39982,27263,12719,4.893
2011-04-19,270799,37405,28620,8785,3.244
2011-04-26,260056,41665,22005,19660,7.56
2011-05-03,258810,38950,19659,19291,7.454
2011-05-10,263054,36570,18890,17680,6.721
2011-05-17,260765,34714,18506,16208,6.216
2011-05-24,260987,41714,14902,26812,10.273
2011-05-31,259345,40881,17637,23244,8.963
2011-06-07,270638,48759,11693,37066,13.696
2011-06-14,265496,47117,12945,34172,12.871
2011-06-21,246508,38571,14561,24010,9.74
2011-06-28,226599,31909,23954,7955,3.511
2011-07-05,214849,30431,25090,5341,2.486
2011-07-12,197799,30672,18244,12428,6.283
2011-07-19,202451,42243,13101,29142,14.395
2011-07-26,208687,47642,8353,39289,18.827
2011-08-02,197453,46914,10476,36438,18.454
2011-08-09,189578,40893,12976,27917,14.726
2011-08-16,190169,37509,13542,23967,12.603
2011-08-23,211876,51178,12474,38704,18.267
2011-08-30,230772,63027,10755,52272,22.651
2011-09-06,233972,71011,11457,59554,25.453
2011-09-13,215377,63387,13745,49642,23.049
2011-09-20,199938,45483,19738,25745,12.876
2011-09-27,204395,33214,22867,10347,5.062
2011-10-04,215479,28929,29527,-598,0.278
2011-10-11,215760,24581,34809,-10228,4.74
2011-10-18,215558,23266,35632,-12366,5.737
2011-10-25,216888,25389,33283,-7894,3.64
2011-11-01,218180,22690,38090,-15400,7.058
2011-11-08,230751,26051,40891,-14840,6.431
2011-11-15,243329,25954,50144,-24190,9.941
2011-11-22,245592,22312,50462,-28150,11.462
2011-11-29,228919,24903,47538,-22635,9.888
2011-12-06,227677,24278,51419,-27141,11.921
2011-12-13,234500,25366,52834,-27468,11.713
2011-12-20,226453,24607,47303,-22696,10.022
2011-12-27,215864,26261,41493,-15232,7.056
2012-01-03,215724,26033,39484,-13451,6.235
2012-01-10,207279,27099,34671,-7572,3.653
2012-01-17,214613,25844,39767,-13923,6.487
2012-01-24,227407,29037,38014,-8977,3.948
2012-01-31,228493,30238,35953,-5715,2.501
2012-02-07,215651,33403,30842,2561,1.188
2012-02-14,210310,33196,29679,3517,1.672
2012-02-21,211257,37402,22575,14827,7.018
2012-02-28,211482,47038,18429,28609,13.528
2012-03-06,234454,62360,10816,51544,21.985
2012-03-13,252030,73659,11441,62218,24.687
2012-03-20,267293,80915,8656,72259,27.034
2012-03-27,271787,85068,8657,76411,28.114
2012-04-03,290352,91350,6600,84750,29.189
2012-04-10,298011,96421,7915,88506,29.699
2012-04-17,305408,99665,5151,94514,30.947
2012-04-24,302754,105890,4272,101618,33.565
2012-05-01,295598,101642,2892,98750,33.407
2012-05-08,294297,100069,2688,97381,33.089
2012-05-15,297818,93869,3834,90035,30.232
2012-05-22,299610,87281,3037,84244,28.118
2012-05-29,300731,82084,2935,79149,26.319
2012-06-05,286361,72023,4914,67109,23.435
2012-06-12,297869,79326,3943,75383,25.307
2012-06-19,315804,83276,2333,80943,25.631
2012-06-26,312498,86581,2210,84371,26.999
2012-07-03,311999,82502,1076,81426,26.098
2012-07-10,315819,81915,280,81635,25.849
2012-07-17,333564,81144,1060,80084,24.009
2012-07-24,328687,72535,2632,69903,21.267
2012-07-31,311118,68656,1838,66818,21.477
2012-08-07,308114,67390,3304,64086,20.799
2012-08-14,323240,73444,2398,71046,21.979
2012-08-21,349656,77085,763,76322,21.828
2012-08-28,325467,75200,1573,73627,22.622
2012-09-04,323361,76211,2499,73712,22.796
2012-09-11,310327,72124,3963,68161,21.964
2012-09-18,312833,65492,5933,59559,19.039
2012-09-25,290177,55012,6765,48247,16.627
2012-10-02,277138,51398,7543,43855,15.824
2012-10-09,275287,50788,7500,43288,15.725
2012-10-16,277390,51144,7726,43418,15.652
2012-10-23,281131,52464,10525,41939,14.918
2012-10-30,289384,59393,10342,49051,16.95
2012-11-06,290458,56492,10146,46346,15.956
2012-11-13,281994,46855,17476,29379,10.418
2012-11-20,280286,44323,16797,27526,9.821
2012-11-27,253348,43290,19575,23715,9.361
2012-12-04,260574,47054,19452,27602,10.593
2012-12-11,270198,53830,15873,37957,14.048
2012-12-18,285846,59457,13879,45578,15.945
2012-12-24,257334,54064,12575,41489,16.123
2012-12-31,253318,52764,14429,38335,15.133
2013-01-08,275774,54328,18140,36188,13.122
2013-01-15,289903,53417,26843,26574,9.167
2013-01-22,305333,57523,21165,36358,11.908
2013-01-29,323734,58796,22844,35952,11.105
2013-02-05,343842,64226,18715,45511,13.236
2013-02-12,338173,68647,21327,47320,13.993
2013-02-19,337965,66080,25101,40979,12.125
2013-02-26,316590,68662,20822,47840,15.111
2013-03-05,324926,75578,19151,56427,17.366
2013-03-12,334363,83063,19861,63202,18.902
2013-03-19,322376,71191,20683,50508,15.667
2013-03-26,318015,62909,20912,41997,13.206
2013-04-02,302995,53297,26044,27253,8.995
2013-04-09,303800,49901,33480,16421,5.405
2013-04-16,301745,52885,28955,23930,7.931
2013-04-23,298215,56022,30613,25409,8.52
2013-04-30,292184,61113,31067,30046,10.283
2013-05-07,290739,59436,30730,28706,9.873
2013-05-14,293883,63292,26798,36494,12.418
2013-05-21,307233,68745,22493,46252,15.054
2013-05-28,317536,75222,20907,54315,17.105
2013-06-04,330323,79934,19337,60597,18.345
2013-06-11,351193,89763,19873,69890,19.901
2013-06-18,362307,88355,23484,64871,17.905
2013-06-25,348744,87000,25388,61612,17.667
2013-07-02,329351,78511,25377,53134,16.133
2013-07-09,325953,72872,24564,48308,14.821
2013-07-16,337145,76489,25130,51359,15.234
2013-07-23,332430,72725,25977,46748,14.063
2013-07-30,303012,66161,33495,32666,10.78
2013-08-06,298173,60657,37284,23373,7.839
2013-08-13,303192,62962,37167,25795,8.508
2013-08-20,319582,74873,30290,44583,13.95
2013-08-27,322437,78696,21734,56962,17.666
2013-09-03,320739,83041,18309,64732,20.182
2013-09-10,327580,80946,12162,68784,20.998
2013-09-17,329168,75929,12539,63390,19.258
2013-09-24,325409,76122,14824,61298,18.837
2013-10-01,314384,72440,16566,55874,17.773
2013-10-08,318758,69149,17995,51154,16.048
2013-10-15,320430,69164,20676,48488,15.132
2013-10-22,331482,72567,19528,53039,16.001
2013-10-29,337119,77292,19872,57420,17.033
2013-11-05,331480,65888,24029,41859,12.628
2013-11-12,345046,71051,19691,51360,14.885
2013-11-19,342903,73370,24025,49345,14.39
2013-11-26,306137,76270,22261,54009,17.642
2013-12-03,312476,78222,19691,58531,18.731
2013-12-10,317475,82616,19158,63458,19.988
2013-12-17,328819,84886,21524,63362,19.27
2013-12-24,322741,81247,20934,60313,18.688
2013-12-31,298229,80499,22568,57931,19.425
2014-01-07,295709,75110,22486,52624,17.796
2014-01-14,312614,83618,24861,58757,18.795
2014-01-21,314826,84526,25002,59524,18.907
2014-01-28,321825,81891,23065,58826,18.279
2014-02-04,339571,90071,23797,66274,19.517
2014-02-11,345670,92840,22263,70577,20.417
2014-02-18,363227,95900,20947,74953,20.635
2014-02-25,354765,96846,23258,73588,20.743
2014-03-04,358655,95771,25639,70132,19.554
2014-03-11,363343,95309,25380,69929,19.246
2014-03-18,366752,95208,25175,70033,19.095
2014-03-25,362819,93807,23234,70573,19.451
2014-04-01,379164,95807,23128,72679,19.168
2014-04-08,388805,94494,22205,72289,18.593
2014-04-15,397270,99364,22680,76684,19.303
2014-04-22,390971,95189,21896,73293,18.746
2014-04-29,375804,95654,20451,75203,20.011
2014-05-06,366543,88514,22886,65628,17.905
2014-05-13,380186,93095,21034,72061,18.954
2014-05-20,384625,91549,20420,71129,18.493
2014-05-27,393610,92792,20750,72042,18.303
2014-06-03,406996,91517,20888,70629,17.354
2014-06-10,407467,88686,20425,68261,16.753
2014-06-17,402253,82068,21974,60094,14.939
2014-06-24,369183,75517,26293,49224,13.333
2014-07-01,370056,74075,34703,39372,10.639
2014-07-08,373131,68509,37393,31116,8.339
2014-07-15,379266,65232,37030,28202,7.436
2014-07-22,386475,61925,33940,27985,7.241
2014-07-29,367288,60634,29792,30842,8.397
2014-08-05,370088,60142,31692,28450,7.687
2014-08-12,377825,63528,27227,36301,9.608
2014-08-19,389775,67382,24739,42643,10.94
2014-08-26,385784,61442,28153,33289,8.629
2014-09-02,401405,74499,26584,47915,11.937
2014-09-09,409544,64232,29689,34543,8.435
2014-09-16,420153,61100,34234,26866,6.394
2014-09-23,436732,59734,34289,25445,5.826
2014-09-30,444590,58852,36304,22548,5.072
2014-10-07,445885,57493,38185,19308,4.33
2014-10-14,450331,61323,34036,27287,6.059
2014-10-21,439924,63644,26071,37573,8.541
2014-10-28,440510,69063,23421,45642,10.361
2014-11-04,463234,81580,21543,60037,12.96
2014-11-11,478324,87020,19917,67103,14.029
2014-11-18,477320,82746,23849,58897,12.339
2014-11-25,444135,84803,26830,57973,13.053
2014-12-02,431151,80973,28763,52210,12.109
2014-12-09,420182,80223,31047,49176,11.703
2014-12-16,426697,76587,33971,42616,9.987
2014-12-23,427032,84216,33868,50348,11.79
2014-12-30,400585,86869,32737,54132,13.513
2015-01-06,394898,81280,33835,47445,12.014
2015-01-13,403722,70030,38580,31450,7.79
2015-01-20,416650,69351,40768,28583,6.86
2015-01-27,433178,70888,36916,33972,7.843
2015-02-03,439073,70184,42429,27755,6.321
2015-02-10,437126,60337,46365,13972,3.196
2015-02-17,437877,68185,44028,24157,5.517
2015-02-24,408939,73407,40871,32536,7.956
2015-03-03,392912,65596,41331,24265,6.176
2015-03-10,400841,68527,42678,25849,6.449
2015-03-17,401259,58088,46963,11125,2.773
2015-03-24,396578,52228,46131,6097,1.537
2015-03-31,397665,59818,45515,14303,3.597
2015-04-07,395137,50813,51459,-646,0.163
2015-04-14,404553,46325,66042,-19717,4.874
2015-04-21,406009,51543,63533,-11990,2.953
2015-04-28,380325,57206,55436,1770,0.465
2015-05-05,382696,54079,55528,-1449,0.379
2015-05-12,408028,52850,64357,-11507,2.82
2015-05-19,411478,51418,60693,-9275,2.254
2015-05-26,435135,55085,64404,-9319,2.142
2015-06-02,457716,56640,64968,-8328,1.819
2015-06-09,467084,59925,60171,-246,0.053
2015-06-16,471308,65385,55272,10113,2.146
2015-06-23,484468,73768,47363,26405,5.45
2015-06-30,447921,85567,45982,39585,8.837
2015-07-07,452377,89301,41524,47777,10.561
2015-07-14,463051,87135,33330,53805,11.62
2015-07-21,475130,91737,30520,61217,12.884
2015-07-28,448106,92051,34189,57862,12.913
2015-08-04,435642,89783,31631,58152,13.349
2015-08-11,449908,89145,33617,55528,12.342
2015-08-18,446512,76978,35952,41026,9.188
2015-08-25,441427,71501,26373,45128,10.223
2015-09-01,425046,64252,29861,34391,8.091
2015-09-08,435946,64461,34899,29562,6.781
2015-09-15,446712,67267,31299,35968,8.052
2015-09-22,444170,60866,42666,18200,4.098
2015-09-29,424037,60564,40721,19843,4.68
2015-10-06,436115,57465,37804,19661,4.508
2015-10-13,461441,67758,37068,30690,6.651
2015-10-20,473682,65017,37762,27255,5.754
2015-10-27,464361,52431,44043,8388,1.806
2015-11-03,471925,51302,50257,1045,0.221
2015-11-10,488379,53897,59256,-5359,1.097
2015-11-17,494600,50793,65474,-14681,2.968
2015-11-24,472852,48012,72278,-24266,5.132
2015-12-01,467557,51113,73426,-22313,4.772
2015-12-08,477281,48939,70712,-21773,4.562
2015-12-15,483004,44274,75464,-31190,6.458
2015-12-22,465681,42036,76221,-34185,7.341
2015-12-29,456689,40758,81601,-40843,8.943
2016-01-05,465827,41805,91193,-49388,10.602
2016-01-12,464707,41699,87775,-46076,9.915
2016-01-19,474896,39939,87205,-47266,9.953
2016-01-26,475888,37755,76077,-38322,8.053
2016-02-02,470699,33253,66452,-33199,7.053
2016-02-09,490072,32663,81521,-48858,9.97
2016-02-16,494216,34096,79147,-45051,9.116
2016-02-23,461698,31426,78168,-46742,10.124
2016-03-01,444548,30731,79450,-48719,10.959
2016-03-08,421302,35774,60013,-24239,5.753
2016-03-15,426711,39642,62633,-22991,5.388
2016-03-22,432073,39054,61164,-22110,5.117
2016-03-29,426004,39737,52915,-13178,3.093
2016-04-05,434689,39186,59403,-20217,4.651
2016-04-12,433292,45066,51757,-6691,1.544
2016-04-19,445419,51142,38006,13136,2.949
2016-04-26,426439,57605,26431,31174,7.31
2016-05-03,424169,61895,19110,42785,10.087
2016-05-10,449673,71943,11752,60191,13.386
2016-05-17,467361,72189,6401,65788,14.076
2016-05-24,463115,75327,4670,70657,15.257
2016-05-31,478491,81549,6297,75252,15.727
2016-06-07,486991,79512,5739,73773,15.149
2016-06-14,502512,77001,7479,69522,13.835
2016-06-21,506374,75287,9417,65870,13.008
2016-06-28,459444,71473,9006,62467,13.596
2016-07-05,455064,72719,11314,61405,13.494
2016-07-12,457297,71207,9272,61935,13.544
2016-07-19,455091,67519,11028,56491,12.413
2016-07-26,432075,68567,12131,56436,13.062
2016-08-02,428672,66749,9988,56761,13.241
2016-08-09,426012,61662,9415,52247,12.264
2016-08-16,429533,59841,12337,47504,11.059
2016-08-23,436911,64081,14198,49883,11.417
2016-08-30,403445,61751,16312,45439,11.263
2016-09-06,413149,56265,21992,34273,8.296
2016-09-13,420612,54578,20391,34187,8.128
2016-09-20,418845,52485,21337,31148,7.437
2016-09-27,420246,45365,33665,11700,2.784
2016-10-04,415688,47045,32215,14830,3.568
2016-10-11,423786,44360,31842,12518,2.954
2016-10-18,432765,47000,33288,13712,3.168
2016-10-25,431782,47484,32996,14488,3.355
2016-11-01,419025,49144,28123,21021,5.017
2016-11-08,423426,49266,33034,16232,3.833
2016-11-15,432977,49100,35096,14004,3.234
2016-11-22,433800,53866,34489,19377,4.467
2016-11-29,398503,54415,35056,19359,4.858
2016-12-06,393308,54134,30867,23267,5.916
2016-12-13,393368,51532,32967,18565,4.719
2016-12-20,391720,49565,33583,15982,4.08
2016-12-27,369594,51896,32359,19537,5.286
2017-01-03,358540,52490,33633,18857,5.259
2017-01-10,369716,55162,32152,23010,6.224
2017-01-17,393045,69176,19680,49496,12.593
2017-01-24,419352,84169,15784,68385,16.307
2017-01-31,417232,85907,19893,66014,15.822
2017-02-07,419089,84645,23820,60825,14.514
2017-02-14,429046,87379,20792,66587,15.52
2017-02-21,431632,90953,17488,73465,17.02
2017-02-28,405369,89105,18623,70482,17.387
2017-03-07,399907,82928,21395,61533,15.387
2017-03-14,394206,81343,21399,59944,15.206
2017-03-21,406913,82874,23540,59334,14.581
2017-03-28,407274,64146,34613,29533,7.251
2017-04-04,420501,62060,48118,13942,3.316
2017-04-11,430439,64586,57050,7536,1.751
2017-04-18,419844,62448,59809,2639,0.629
2017-04-25,394527,58268,60074,-1806,0.458
2017-05-02,401680,56180,61123,-4943,1.231
2017-05-09,401778,58619,58656,-37,0.009
2017-05-16,407460,56568,68256,-11688,2.869
2017-05-23,435533,49420,84881,-35461,8.142
2017-05-30,449312,47277,91777,-44500,9.904
2017-06-06,456565,45080,96021,-50941,11.157
2017-06-13,454939,47674,92420,-44746,9.836
2017-06-20,445273,46573,91683,-45110,10.131
2017-06-27,417171,45292,99722,-54430,13.047
2017-07-03,404873,43235,86202,-42967,10.612
2017-07-11,400066,52262,59472,-7210,1.802
2017-07-18,398978,50204,50840,-636,0.159
2017-07-25,382672,46802,51183,-4381,1.145
2017-08-01,379853,42619,50033,-7414,1.952
2017-08-08,387970,39017,53374,-14357,3.701
2017-08-15,406823,39389,64964,-25575,6.287
2017-08-22,427563,39754,74309,-34555,8.082
2017-08-29,420490,37794,73946,-36152,8.598
2017-09-05,422614,37700,74044,-36344,8.6
2017-09-12,424870,40465,72282,-31817,7.489
2017-09-19,415551,42555,59474,-16919,4.071
2017-09-26,402229,44501,49993,-5492,1.365
2017-10-03,397951,47217,46062,1155,0.29
2017-10-10,396958,49207,36152,13055,3.289
2017-10-17,416353,51467,30340,21127,5.074
2017-10-24,425560,52431,34752,17679,4.154
2017-10-31,426242,47617,39004,8613,2.021
2017-11-07,425540,46546,38111,8435,1.982
2017-11-14,437493,46784,40478,6306,1.441
2017-11-21,442489,50427,34518,15909,3.595
2017-11-28,439901,62392,23692,38700,8.797
2017-12-05,475596,80035,16128,63907,13.437
2017-12-12,456741,83005,15289,67716,14.826
2017-12-19,445181,69104,20635,48469,10.887
2017-12-26,425347,64672,33415,31257,7.349
2018-01-02,414796,60314,41629,18685,4.505
2018-01-09,418712,59265,43531,15734,3.758
2018-01-16,428531,57721,49647,8074,1.884
2018-01-23,457462,68946,35725,33221,7.262
2018-01-30,469396,74593,19358,55235,11.767
2018-02-06,492316,70772,18769,52003,10.563
2018-02-13,539075,82642,11651,70991,13.169
2018-02-20,557582,92757,7668,85089,15.26
2018-02-27,508077,113883,7603,106280,20.918
2018-03-06,510861,121252,5752,115500,22.609
2018-03-13,512779,116576,5127,111449,21.734
2018-03-20,507869,106932,7454,99478,19.587
2018-03-27,517981,107725,5652,102073,19.706
2018-04-03,534398,104120,5893,98227,18.381
2018-04-10,570068,114672,5302,109370,19.185
2018-04-17,588589,113969,4817,109152,18.545
2018-04-24,556334,110780,5359,105421,18.949
2018-05-01,587565,136231,2682,133549,22.729
2018-05-08,580661,132141,1756,130385,22.455
2018-05-15,588612,124779,3247,121532,20.647
2018-05-22,584648,119092,3796,115296,19.721
2018-05-29,591836,118154,5366,112788,19.057
2018-06-05,578191,107849,7003,100846,17.442
2018-06-12,580300,100477,10960,89517,15.426
2018-06-19,594016,98787,15213,83574,14.069
2018-06-26,545769,85149,22013,63136,11.568
2018-07-03,565599,79665,23655,56010,9.903
2018-07-10,573033,77611,26285,51326,8.957
2018-07-17,585171,79953,26575,53378,9.122
2018-07-24,584459,79647,29707,49940,8.545
2018-07-31,569042,82096,29489,52607,9.245
2018-08-07,559065,76788,29988,46800,8.371
2018-08-14,571753,84861,27968,56893,9.951
2018-08-21,556148,80094,27361,52733,9.482
2018-08-28,563031,72525,45076,27449,4.875
2018-09-04,576598,70378,48977,21401,3.712
2018-09-11,583032,72011,41877,30134,5.168
2018-09-18,591453,69952,48063,21889,3.701
2018-09-25,566081,65945,44740,21205,3.746
2018-10-02,566182,72593,46250,26343,4.653
2018-10-09,572200,77230,38467,38763,6.774
2018-10-16,581835,76849,34859,41990,7.217
2018-10-23,581101,72858,36303,36555,6.291
2018-10-30,593252,69608,45709,23899,4.028
2018-11-06,568861,62542,43021,19521,3.432
2018-11-13,559928,55071,53036,2035,0.363
2018-11-20,554804,52988,52114,874,0.158
2018-11-27,511839,49438,57242,-7804,1.525
2018-12-04,497877,49659,52621,-2962,0.595
2018-12-11,488389,47417,55257,-7840,1.605
2018-12-18,470693,47098,51514,-4416,0.938
2018-12-24,462030,49258,49872,-614,0.133
2018-12-31,453318,48989,43486,5503,1.214
2019-01-08,475402,57247,31237,26010,5.471
2019-01-15,478760,51214,40456,10758,2.247
2019-01-22,487546,50162,43270,6892,1.414
2019-01-29,494047,49281,48174,1107,0.224
2019-02-05,499270,43246,57996,-14750,2.954
2019-02-12,498296,41044,70673,-29629,5.946
2019-02-19,499100,42918,82877,-39959,8.006
2019-02-26,475375,40228,88844,-48616,10.227
2019-03-05,472620,46122,88322,-42200,8.929
2019-03-12,486153,47197,91740,-44543,9.162
2019-03-19,484657,48850,78695,-29845,6.158
2019-03-26,488264,53447,65510,-12063,2.471
2019-04-02,486026,51436,63853,-12417,2.555
2019-04-09,477077,52597,61212,-8615,1.806
2019-04-16,477608,53363,64897,-11534,2.415
2019-04-23,482766,54853,74282,-19429,4.025
2019-04-30,491543,56255,71854,-15599,3.173
2019-05-07,515579,54484,87619,-33135,6.427
2019-05-14,535203,54243,93876,-39633,7.405
2019-05-21,543303,49275,84289,-35014,6.445
2019-05-28,537445,52606,72967,-20361,3.788
2019-06-04,529467,49706,47543,2163,0.409
2019-06-11,523342,48393,43728,4665,0.891
2019-06-18,537428,42008,41990,18,0.003
2019-06-25,492270,39988,40898,-910,0.185
2019-07-02,467675,37962,52612,-14650,3.133
2019-07-09,471835,38905,59352,-20447,4.334
2019-07-16,476053,39529,60543,-21014,4.414
2019-07-23,484809,38531,64210,-25679,5.297
2019-07-30,455791,38764,71058,-32294,7.085
2019-08-06,475751,42014,81077,-39063,8.211
2019-08-13,476971,43956,80380,-36424,7.637
2019-08-20,481674,42633,78795,-36162,7.508
2019-08-27,474296,42834,77851,-35017,7.383
2019-09-03,469818,42471,85999,-43528,9.265
2019-09-10,476748,40998,88604,-47606,9.986
2019-09-17,474927,36384,91135,-54751,11.528
2019-09-24,465286,42385,90368,-47983,10.313
2019-10-01,446938,45539,85096,-39557,8.851
2019-10-08,445811,45467,78207,-32740,7.344
2019-10-15,453518,45807,70877,-25070,5.528
2019-10-22,450469,46646,67855,-21209,4.708
2019-10-29,451719,42972,72022,-29050,6.431
2019-11-05,470113,36439,73993,-37554,7.988
2019-11-12,454812,43675,67158,-23483,5.163
2019-11-19,454624,41885,61445,-19560,4.302
2019-11-26,446390,43785,76093,-32308,7.238
2019-12-03,463884,43864,87774,-43910,9.466
2019-12-10,477057,45819,78520,-32701,6.855
2019-12-17,489233,49321,80666,-31345,6.407
2019-12-24,482739,49729,74075,-24346,5.043
2019-12-31,454476,50083,75493,-25410,5.591
2020-01-07,469191,52703,80617,-27914,5.949
2020-01-14,489872,52223,83943,-31720,6.475
2020-01-21,500274,51265,87961,-36696,7.335
2020-01-28,512178,49179,88898,-39719,7.755
2020-02-04,530653,40312,104689,-64377,12.132
2020-02-11,535353,42411,110561,-68150,12.73
2020-02-18,538260,43703,116171,-72468,13.463
2020-02-25,530638,43519,120631,-77112,14.532
2020-03-03,481543,50843,69167,-18324,3.805
2020-03-10,485172,51065,53200,-2135,0.44
2020-03-17,462122,53715,37615,16100,3.484
2020-03-24,454698,56351,17252,39099,8.599
2020-03-31,439265,61205,11586,49619,11.296
2020-04-07,439783,49192,17645,31547,7.173
2020-04-14,452826,43087,37335,5752,1.27
2020-04-21,454460,40868,41014,-146,0.032
2020-04-28,449720,39856,47820,-7964,1.771
2020-05-05,459415,38984,50684,-11700,2.547
2020-05-12,479565,40405,51532,-11127,2.32
2020-05-19,489652,39468,68872,-29404,6.005
2020-05-26,495460,36684,78459,-41775,8.432
2020-06-02,503208,35335,86316,-50981,10.131
2020-06-09,494752,35331,88317,-52986,10.71
2020-06-16,498341,35876,84084,-48208,9.674
2020-06-23,502157,35880,81892,-46012,9.163
2020-06-30,480264,38106,90603,-52497,10.931
2020-07-07,475449,44688,66598,-21910,4.608
2020-07-14,463141,37695,68146,-30451,6.575
2020-07-21,473404,40875,70053,-29178,6.163
2020-07-28,466434,42346,61810,-19464,4.173
2020-08-04,476417,43231,64216,-20985,4.405
2020-08-11,491275,42928,72219,-29291,5.962
2020-08-18,490048,53666,42687,10979,2.24
2020-08-25,483723,49579,46019,3560,0.736
2020-09-01,491520,53449,37578,15871,3.229
2020-09-08,501873,59000,26881,32119,6.4
2020-09-15,510033,65113,21416,43697,8.567
2020-09-22,539843,79330,14082,65248,12.086
2020-09-29,499034,85344,12345,72999,14.628
2020-10-06,526287,89118,12051,77067,14.644
2020-10-13,518135,89828,12760,77068,14.874
2020-10-20,522739,95606,13982,81624,15.615
2020-10-27,532715,98359,14080,84279,15.821
2020-11-03,531000,96446,11316,85130,16.032
2020-11-10,547724,95788,11990,83798,15.299
2020-11-17,557002,87765,9279,78486,14.091
2020-11-24,485195,85226,14091,71135,14.661
2020-12-01,475823,84822,14436,70386,14.792
2020-12-08,479328,82689,20047,62642,13.069
2020-12-15,492444,83806,6599,77207,15.678
2020-12-21,511728,89909,6524,83385,16.295
2020-12-29,481102,95748,6261,89487,18.6
2021-01-05,486734,92095,7501,84594,17.38
2021-01-12,499855,90809,6401,84408,16.886
2021-01-19,490258,84653,7022,77631,15.835
2021-01-26,483384,81908,7318,74590,15.431
2021-02-02,483991,75375,7864,67511,13.949
2021-02-09,497713,76425,6800,69625,13.989
2021-02-16,497653,76917,7495,69422,13.95
2021-02-23,464978,76460,6973,69487,14.944
2021-03-02,461010,74428,9004,65424,14.191
2021-03-09,471502,73970,9726,64244,13.625
2021-03-16,477067,69953,8717,61236,12.836
2021-03-23,472467,66704,9084,57620,12.196
2021-03-30,470594,67355,9120,58235,12.375
2021-04-06,476527,68056,6711,61345,12.873
2021-04-13,477525,58799,14969,43830,9.179
2021-04-20,477120,58438,10391,48047,10.07
2021-04-27,459296,62286,8200,54086,11.776
2021-05-04,457234,65568,11418,54150,11.843
2021-05-11,489758,75499,5883,69616,14.214
2021-05-18,467317,60786,9941,50845,10.88
2021-05-25,456909,49794,24562,25232,5.522
2021-06-01,457200,45155,24270,20885,4.568
2021-06-08,463283,47345,20625,26720,5.768
2021-06-15,468746,45930,26838,19092,4.073
2021-06-22,464731,47358,27226,20132,4.332
2021-06-29,431181,47665,31852,15813,3.667
2021-07-06,426916,45502,24538,20964,4.911
2021-07-13,417092,44955,28251,16704,4.005
2021-07-20,420801,47537,26040,21497,5.109
2021-07-27,398615,48934,26741,22193,5.568
2021-08-03,399064,47657,29728,17929,4.493
2021-08-10,402359,52039,26813,25226,6.27
2021-08-17,407639,50895,23155,27740,6.805
2021-08-24,404589,48521,27793,20728,5.123
2021-08-31,384278,49587,37731,11856,3.085
2021-09-07,398937,47384,55146,-7762,1.946
2021-09-14,401560,43848,60180,-16332,4.067
2021-09-21,406065,40404,58957,-18553,4.569
2021-09-28,397196,44286,59250,-14964,3.767
2021-10-05,444953,40070,72134,-32064,7.206
2021-10-12,470906,39400,79724,-40324,8.563
2021-10-19,490823,41515,73674,-32159,6.552
2021-10-26,484541,46405,61546,-15141,3.125
2021-11-02,492363,52026,58360,-6334,1.286
2021-11-09,499172,56442,47143,9299,1.863
2021-11-16,519884,61233,23745,37488,7.211
2021-11-23,497835,66417,12858,53559,10.758
2021-11-30,430317,55113,17432,37681,8.757
2021-12-07,418151,49998,22100,27898,6.672
2021-12-14,434693,57967,17433,40534,9.325
2021-12-21,452464,63601,13050,50551,11.172
2021-12-28,430303,72021,10859,61162,14.214
2022-01-04,436279,82429,11661,70768,16.221
2022-01-11,454258,84290,11370,72920,16.053
2022-01-18,458623,81918,17175,64743,14.117
2022-01-25,451424,76372,12038,64334,14.251
2022-02-01,478164,85425,8682,76743,16.05
2022-02-08,510347,96193,8055,88138,17.27
2022-02-15,524560,97397,8227,89170,16.999
2022-02-22,489168,97780,7363,90417,18.484
2022-03-01,452265,99359,4530,94829,20.968
2022-03-08,439326,99880,3253,96627,21.994
2022-03-15,447497,105001,1842,103159,23.052
2022-03-22,457776,103731,2567,101164,22.099
2022-03-29,455338,102370,2422,99948,21.95
2022-04-05,460780,103224,2680,100544,21.82
2022-04-12,461136,97314,3903,93411,20.257
2022-04-19,466468,102570,3028,99542,21.34
2022-04-26,424438,97181,5890,91291,21.509
2022-05-03,410282,86009,12258,73751,17.976
2022-05-10,409858,70684,18370,52314,12.764
2022-05-17,413267,58853,22930,35923,8.692
2022-05-24,405915,62291,13137,49154,12.109
2022-05-31,418915,63912,16550,47362,11.306
2022-06-07,429842,64539,11370,53169,12.369
2022-06-14,435560,63890,11433,52457,12.044
2022-06-21,456803,70163,9782,60381,13.218
2022-06-28,430815,71413,8956,62457,14.497
2022-07-05,435036,74867,9090,65777,15.12
2022-07-12,440090,73694,5404,68290,15.517
2022-07-19,444043,74082,7494,66588,14.996
2022-07-26,438045,79562,6182,73380,16.752
2022-08-02,443344,84292,4274,80018,18.049
2022-08-09,455180,89609,5227,84382,18.538
2022-08-16,462717,93925,7661,86264,18.643
2022-08-23,474763,99420,3702,95718,20.161
2022-08-30,435028,97555,3929,93626,21.522
2022-09-06,431875,92676,11055,81621,18.899
2022-09-13,428745,95603,7889,87714,20.458
2022-09-20,445424,106864,4696,102168,22.937
2022-09-27,422486,100024,6479,93545,22.142
2022-10-04,401198,90563,10863,79700,19.866
2022-10-11,403425,83656,13267,70389,17.448
2022-10-18,414496,85148,14351,70797,17.08
2022-10-25,426681,95821,9791,86030,20.163
2022-11-01,435093,104142,10725,93417,21.471
2022-11-08,453467,105440,10020,95420,21.042
2022-11-15,440919,90607,14897,75710,17.171
2022-11-22,433521,88420,16605,71815,16.566
2022-11-29,394594,90480,15619,74861,18.972
2022-12-06,427153,107043,8534,98509,23.062
2022-12-13,438398,118372,3886,114486,26.115
2022-12-20,453264,124390,3127,121263,26.753
2022-12-27,435113,133536,3547,129989,29.875
2023-01-03,445612,144106,2229,141877,31.839
2023-01-10,454472,145226,2515,142711,31.401
2023-01-17,463876,153531,2592,150939,32.539
2023-01-24,470373,143492,7989,135503,28.808
2023-01-31,477982,147248,6305,140943,29.487
2023-02-07,488770,149503,6793,142710,29.198
2023-02-14,512704,156972,4573,152399,29.725
2023-02-21,517351,159386,5245,154141,29.794
2023-02-28,462185,149950,9979,139971,30.285
2023-03-07,496776,165533,10470,155063,31.214
2023-03-14,489810,149290,15320,133970,27.351
2023-03-21,481613,130118,14904,115214,23.923
2023-03-28,466859,112153,16024,96129,20.591
2023-04-04,487963,111420,15685,95735,19.619
2023-04-11,485932,109900,14220,95680,19.69
2023-04-18,504548,121250,15568,105682,20.946
2023-04-25,482573,107526,21153,86373,17.898
2023-05-02,473433,83479,22922,60557,12.791
2023-05-09,501524,84497,22235,62262,12.415
2023-05-16,519702,96805,16518,80287,15.449
2023-05-23,539152,94062,20273,73789,13.686
2023-05-30,538779,79443,19767,59676,11.076
2023-06-06,551768,85420,19604,65816,11.928
2023-06-13,575837,81540,20932,60608,10.525
2023-06-20,569348,80719,16795,63924,11.228
2023-06-27,532054,77281,18301,58980,11.085
2023-07-03,523338,72823,20002,52821,10.093
2023-07-11,525326,72277,18078,54199,10.317
2023-07-18,541989,76325,17376,58949,10.876
2023-07-25,541425,88086,17912,70174,12.961
2023-08-01,538487,89932,19581,70351,13.065
2023-08-08,538178,84693,15550,69143,12.848
2023-08-15,536935,76339,19479,56860,10.59
2023-08-22,520657,74958,22138,52820,10.145
2023-08-29,502621,84754,11001,73753,14.674
2023-09-05,494519,78523,13401,65122,13.169
2023-09-12,500943,77152,14950,62202,12.417
2023-09-19,506396,69522,13649,55873,11.033
2023-09-26,508091,74543,15347,59196,11.651
2023-10-03,515598,71550,30565,40985,7.949
2023-10-10,511785,67749,35690,32059,6.264
2023-10-17,540196,77842,27144,50698,9.385
2023-10-24,568594,102232,10205,92027,16.185
2023-10-31,588359,119309,12726,106583,18.115
2023-11-07,609640,120684,8697,111987,18.369
2023-11-14,646145,138576,7172,131404,20.337
2023-11-21,671039,146980,9177,137803,20.536
2023-11-28,617529,148626,12828,135798,21.991
2023-12-05,594283,135435,17253,118182,19.886
2023-12-12,565774,112850,20130,92720,16.388
2023-12-19,564236,101375,26519,74856,13.267
2023-12-26,508260,91616,32383,59233,11.654
2024-01-02,489873,87277,44238,43039,8.786
2024-01-09,515526,70519,60058,10461,2.029
2024-01-16,547287,63774,67853,-4079,0.745
2024-01-23,566127,55350,74366,-19016,3.359
2024-01-30,563983,51924,73992,-22068,3.913
2024-02-06,578099,58136,72726,-14590,2.524
2024-02-13,597172,60528,88120,-27592,4.62
2024-02-20,598616,64197,94881,-30684,5.126
2024-02-27,540992,60747,108397,-47650,8.808
2024-03-05,540921,64038,113564,-49526,9.156
2024-03-12,535541,61391,112326,-50935,9.511
2024-03-19,549577,64080,110954,-46874,8.529
2024-03-26,544389,70633,100422,-29789,5.472
2024-04-02,558695,66128,109020,-42892,7.677
2024-04-09,547271,70283,94355,-24072,4.399
2024-04-16,545075,81701,92244,-10543,1.934
2024-04-23,543681,99796,80115,19681,3.62
2024-04-30,498943,112264,68668,43596,8.738
2024-05-07,526380,121611,33620,87991,16.716
2024-05-14,534529,131858,32648,99210,18.56
2024-05-21,529615,134962,34018,100944,19.06
2024-05-28,536628,146805,28523,118282,22.042
2024-06-04,541468,131699,31000,100699,18.597
2024-06-11,546457,121370,28463,92907,17.002
