Report_Date,Open_Interest_All,MM_Long_All,MM_Short_All,Net_Position,Percent_of_OpenInterest
2006-06-13,283576,56074,14522,41552,14.653
2006-06-20,274033,39927,20096,19831,7.237
2006-06-27,249213,39994,13903,26091,10.469
2006-07-03,268341,53249,12314,40935,15.255
2006-07-11,301281,76595,12493,64102,21.276
2006-07-18,313126,79255,15377,63878,20.4
2006-07-25,305727,72804,14004,58800,19.233
2006-08-01,308851,68863,11006,57857,18.733
2006-08-08,299780,68192,9342,58850,19.631
2006-08-15,287874,49830,15456,34374,11.941
2006-08-22,289585,43995,15917,28078,9.696
2006-08-29,285727,39609,24278,15331,5.366
2006-09-05,279157,37851,25888,11963,4.285
2006-09-12,286750,33443,34540,-1097,0.383
2006-09-19,295106,33875,39149,-5274,1.787
2006-09-26,287221,27581,39443,-11862,4.13
2006-10-03,283318,25809,44213,-18404,6.496
2006-10-10,281871,24596,38244,-13648,4.842
2006-10-17,288196,28108,27291,817,0.283
2006-10-24,284082,31879,6890,24989,8.796
2006-10-31,296845,40740,10241,30499,10.274
2006-11-07,307139,49820,10441,39379,12.821
2006-11-14,323188,60835,7273,53562,16.573
2006-11-21,313991,62119,6973,55146,17.563
2006-11-28,320744,60515,6760,53755,16.759
2006-12-05,313362,62821,9357,53464,17.061
2006-12-12,309287,61953,10179,51774,16.74
2006-12-19,305179,55747,9847,45900,15.04
2006-12-26,292012,51511,9352,42159,14.437
2007-01-03,287650,55397,11410,43987,15.292
2007-01-09,284729,53909,14227,39682,13.937
2007-01-16,285977,51011,11065,39946,13.968
2007-01-23,301040,59597,6688,52909,17.575
2007-01-30,297968,58442,4750,53692,18.019
2007-02-06,317960,73286,9774,63512,19.975
2007-02-13,332968,72321,9726,62595,18.799
2007-02-20,331389,70091,7991,62100,18.739
2007-02-27,311955,71807,3999,67808,21.736
2007-03-06,296781,62906,6297,56609,19.074
2007-03-13,301952,62905,5982,56923,18.852
2007-03-20,315477,66343,6685,59658,18.91
2007-03-27,342741,78406,6972,71434,20.842
2007-04-03,352807,80819,5019,75800,21.485
2007-04-10,360431,86246,5461,80785,22.413
2007-04-17,351314,81053,6797,74256,21.137
2007-04-24,329345,71990,8649,63341,19.232
2007-05-01,333678,81431,5616,75815,22.721
2007-05-08,325126,78360,5587,72773,22.383
2007-05-15,336549,80892,3810,77082,22.904
2007-05-22,341846,80358,4528,75830,22.183
2007-05-29,353686,81137,6758,74379,21.03
2007-06-05,380041,81015,3191,77824,20.478
2007-06-12,359127,79599,2809,76790,21.382
2007-06-19,354553,78751,2297,76454,21.563
2007-06-26,319501,63399,3642,59757,18.703
2007-07-03,319675,72085,4452,67633,21.157
2007-07-10,322515,75348,5640,69708,21.614
2007-07-17,336816,72560,6079,66481,19.738
2007-07-24,333832,69439,6002,63437,19.003
2007-07-31,327776,67317,7068,60249,18.381
2007-08-07,319972,62888,10046,52842,16.515
2007-08-14,327883,57031,11338,45693,13.936
2007-08-21,329631,39653,16598,23055,6.994
2007-08-28,299997,39338,16146,23192,7.731
2007-09-04,297412,46364,9835,36529,12.282
2007-09-11,302768,54371,6832,47539,15.701
2007-09-18,315060,60977,7117,53860,17.095
2007-09-25,311430,60955,6929,54026,17.348
2007-10-02,298860,55344,7011,48333,16.172
2007-10-09,303755,57625,8094,49531,16.306
2007-10-16,310248,61589,6772,54817,17.669
2007-10-23,323190,60415,7346,53069,16.42
2007-10-30,338987,61038,6629,54409,16.05
2007-11-06,353411,65863,6380,59483,16.831
2007-11-13,354007,63072,7026,56046,15.832
2007-11-20,346257,62324,6350,55974,16.165
2007-11-27,360244,62564,7518,55046,15.28
2007-12-04,349507,62565,6090,56475,16.158
2007-12-11,335195,55344,5982,49362,14.726
2007-12-18,340898,52242,8489,43753,12.835
2007-12-24,328442,57416,5593,51823,15.778
2007-12-31,320931,57552,4308,53244,16.59
2008-01-08,330139,60094,6777,53317,16.15
2008-01-15,333217,55576,7377,48199,14.465
2008-01-22,342589,51586,9201,42385,12.372
2008-01-29,332133,46543,11338,35205,10.6
2008-02-05,341030,49980,11569,38411,11.263
2008-02-12,342671,51046,13053,37993,11.087
2008-02-19,353482,49235,13880,35355,10.002
2008-02-26,347138,52307,13163,39144,11.276
2008-03-04,351499,47767,15165,32602,9.275
2008-03-11,355624,40595,13605,26990,7.589
2008-03-18,354364,30435,15308,15127,4.269
2008-03-25,355200,26394,15904,10490,2.953
2008-04-01,376178,27633,13248,14385,3.824
2008-04-08,358271,22990,16141,6849,1.912
2008-04-15,350329,33339,14870,18469,5.272
2008-04-22,353756,36436,13850,22586,6.385
2008-04-29,320652,32599,14938,17661,5.508
2008-05-06,305808,29394,10359,19035,6.224
2008-05-13,310743,35372,10781,24591,7.914
2008-05-20,300551,31909,13192,18717,6.228
2008-05-27,299502,32912,14467,18445,6.159
2008-06-03,304569,32442,14067,18375,6.033
2008-06-10,317252,33656,17300,16356,5.156
2008-06-17,325169,36241,13782,22459,6.907
2008-06-24,299269,36001,14770,21231,7.094
2008-07-01,301805,37273,10421,26852,8.897
2008-07-08,302299,32179,13437,18742,6.2
2008-07-15,303754,30362,13694,16668,5.487
2008-07-22,310471,25763,18911,6852,2.207
2008-07-29,296292,23474,17808,5666,1.912
2008-08-05,299973,24594,20554,4040,1.347
2008-08-12,320641,17048,21454,-4406,1.374
2008-08-19,316241,15477,18456,-2979,0.942
2008-08-26,314749,18410,19040,-630,0.2
2008-09-02,311483,19411,19393,18,0.006
2008-09-09,330196,17314,24605,-7291,2.208
2008-09-16,341022,14473,24504,-10031,2.941
2008-09-23,323420,18917,22981,-4064,1.257
2008-09-30,319854,19737,20322,-585,0.183
2008-10-07,335790,17831,18900,-1069,0.318
2008-10-14,346659,17066,18279,-1213,0.35
2008-10-21,341689,15018,23819,-8801,2.576
2008-10-28,336701,12696,20484,-7788,2.313
2008-11-04,331137,11912,19198,-7286,2.2
2008-11-11,334827,11250,16725,-5475,1.635
2008-11-18,327226,8342,16536,-8194,2.504
2008-11-25,276863,8233,16574,-8341,3.013
2008-12-02,270790,8092,19630,-11538,4.261
2008-12-09,257072,6696,20522,-13826,5.378
2008-12-16,261880,9845,18750,-8905,3.4
2008-12-22,254170,13192,19759,-6567,2.584
2008-12-30,245171,13915,21086,-7171,2.925
2009-01-06,236752,15225,18972,-3747,1.583
2009-01-13,240463,14757,14523,234,0.097
2009-01-20,251296,14539,17910,-3371,1.341
2009-01-27,249622,14476,20026,-5550,2.223
2009-02-03,259510,16334,25073,-8739,3.368
2009-02-10,250936,13366,22675,-9309,3.71
2009-02-17,263380,10679,24774,-14095,5.352
2009-02-24,237776,10125,26581,-16456,6.921
2009-03-03,239878,11447,30646,-19199,8.004
2009-03-10,237650,12652,29135,-16483,6.936
2009-03-17,240044,11075,33176,-22101,9.207
2009-03-24,241550,12536,28647,-16111,6.67
2009-03-31,241849,14989,23255,-8266,3.418
2009-04-07,244547,17880,18981,-1101,0.45
2009-04-14,254905,21425,14712,6713,2.634
2009-04-21,252691,24020,15428,8592,3.4
2009-04-28,239257,24782,15443,9339,3.903
2009-05-05,244315,31465,15559,15906,6.51
2009-05-12,252243,36438,13715,22723,9.008
2009-05-19,266450,36941,21422,15519,5.824
2009-05-26,277931,35612,23443,12169,4.378
2009-06-02,285220,42275,20680,21595,7.571
2009-06-09,300556,42333,21719,20614,6.859
2009-06-16,313639,27679,26816,863,0.275
2009-06-23,306744,27031,29277,-2246,0.732
2009-06-30,283193,23233,32219,-8986,3.173
2009-07-07,287266,18379,37819,-19440,6.767
2009-07-14,299717,17295,42249,-24954,8.326
2009-07-21,299095,17662,39975,-22313,7.46
2009-07-28,281698,17475,36538,-19063,6.767
2009-08-04,295818,24361,28657,-4296,1.452
2009-08-11,291621,27823,23632,4191,1.437
2009-08-18,280627,24520,21666,2854,1.017
2009-08-25,274870,28499,20738,7761,2.824
2009-09-01,269212,23333,33082,-9749,3.621
2009-09-08,259111,22800,41618,-18818,7.263
2009-09-15,263190,25742,43691,-17949,6.82
2009-09-22,255076,26161,44364,-18203,7.136
2009-09-29,250762,24472,45770,-21298,8.493
2009-10-06,243041,26346,46092,-19746,8.125
2009-10-13,272851,32038,37768,-5730,2.1
2009-10-20,283245,39669,26953,12716,4.489
2009-10-27,289078,46725,18846,27879,9.644
2009-11-03,282918,38368,17948,20420,7.218
2009-11-09,286457,35779,15419,20360,7.108
2009-11-17,312964,50127,9725,40402,12.909
2009-11-24,287202,58694,5633,53061,18.475
2009-12-01,294010,58694,4828,53866,18.321
2009-12-08,274347,57759,4020,53739,19.588
2009-12-15,268540,53189,5753,47436,17.664
2009-12-22,259981,39341,9776,29565,11.372
2009-12-29,241324,40071,10115,29956,12.413
2010-01-05,240248,49450,7876,41574,17.305
2010-01-12,247076,41947,11562,30385,12.298
2010-01-19,253047,30857,16370,14487,5.725
2010-01-26,269833,31394,26888,4506,1.67
2010-02-02,296768,33630,31658,1972,0.664
2010-02-09,336428,37916,29221,8695,2.585
2010-02-16,336843,42494,20974,21520,6.389
2010-02-23,324979,43075,17273,25802,7.94
2010-03-02,318484,46166,12362,33804,10.614
2010-03-09,324869,52552,16039,36513,11.239
2010-03-16,323972,46209,15260,30949,9.553
2010-03-23,322355,39773,13071,26702,8.283
2010-03-30,325054,32791,18376,14415,4.435
2010-04-06,338795,42910,17126,25784,7.611
2010-04-13,331537,52709,15862,36847,11.114
2010-04-20,335659,40115,18363,21752,6.48
2010-04-27,309239,32901,18357,14544,4.703
2010-05-04,311762,30202,33296,-3094,0.992
2010-05-11,325116,33388,38674,-5286,1.626
2010-05-18,340739,29877,49093,-19216,5.64
2010-05-25,360102,28080,59405,-31325,8.699
2010-06-01,370047,32322,50474,-18152,4.905
2010-06-08,386301,29902,56537,-26635,6.895
2010-06-15,381437,32766,52020,-19254,5.048
2010-06-22,363873,33003,42604,-9601,2.639
2010-06-29,335813,26147,57235,-31088,9.258
2010-07-06,340049,24580,65588,-41008,12.059
2010-07-13,333110,34635,53289,-18654,5.6
2010-07-20,330238,36313,40380,-4067,1.232
2010-07-27,327045,40964,31103,9861,3.015
2010-08-03,348204,57221,21699,35522,10.201
2010-08-10,373184,65750,21433,44317,11.875
2010-08-17,378961,71360,16314,55046,14.526
2010-08-24,333593,53427,17318,36109,10.824
2010-08-31,313603,45248,21956,23292,7.427
2010-09-07,324673,49491,22256,27235,8.388
2010-09-14,344716,57917,16835,41082,11.918
2010-09-21,382003,69343,14603,54740,14.33
2010-09-28,396789,84610,15408,69202,17.441
2010-10-05,383139,91076,11695,79381,20.719
2010-10-12,407654,83365,9088,74277,18.221
2010-10-19,424199,84123,9787,74336,17.524
2010-10-26,447561,80507,10570,69937,15.626
2010-11-02,467877,83275,11836,71439,15.269
2010-11-09,497696,74843,14448,60395,12.135
2010-11-16,480888,62615,11337,51278,10.663
2010-11-23,479154,55375,10490,44885,9.368
2010-11-30,398807,54324,10460,43864,10.999
2010-12-07,424594,61503,12781,48722,11.475
2010-12-14,439474,66660,12247,54413,12.381
2010-12-21,443967,68421,11380,57041,12.848
2010-12-28,429409,67584,10623,56961,13.265
2011-01-04,438899,67123,10964,56159,12.795
2011-01-11,448075,68126,10975,57151,12.755
2011-01-18,460591,71852,10699,61153,13.277
2011-01-25,466701,63573,14226,49347,10.574
2011-02-01,491175,80962,10066,70896,14.434
2011-02-08,503024,87386,9511,77875,15.481
2011-02-15,490148,77394,14919,62475,12.746
2011-02-22,439190,66879,18501,48378,11.015
2011-03-01,439456,75092,15447,59645,13.572
2011-03-08,447828,75972,10799,65173,14.553
2011-03-15,465171,58516,15071,43445,9.34
2011-03-22,432544,58541,15174,43367,10.026
2011-03-29,445532,62789,12914,49875,11.194
2011-04-05,470843,77127,14686,62441,13.262
2011-04-12,460522,72243,14407,57836,12.559
2011-04-19,442448,70528,13830,56698,12.815
2011-04-26,409262,71784,14759,57025,13.934
2011-05-03,393035,67069,17030,50039,12.731
2011-05-10,383144,51801,20812,30989,8.088
2011-05-17,387293,50064,23666,26398,6.816
2011-05-24,389434,59479,17912,41567,10.674
2011-05-31,394319,67671,13546,54125,13.726
2011-06-07,403818,75472,12771,62701,15.527
2011-06-14,397121,65678,20581,45097,11.356
2011-06-21,397411,60039,23887,36152,9.097
2011-06-28,332449,52518,25315,27203,8.183
2011-07-05,328507,48542,32708,15834,4.82
2011-07-12,325971,52047,24114,27933,8.569
2011-07-19,344290,57740,22282,35458,10.299
2011-07-26,320975,51465,24442,27023,8.419
2011-08-02,328367,54166,27039,27127,8.261
2011-08-09,334757,40208,42717,-2509,0.749
2011-08-16,330263,40430,39913,517,0.157
2011-08-23,327128,42327,29578,12749,3.897
2011-08-30,323377,57301,12346,44955,13.902
2011-09-06,324762,61258,11597,49661,15.292
2011-09-13,338985,59372,12317,47055,13.881
2011-09-20,334341,53707,20272,33435,10.0
2011-09-27,343155,46227,33834,12393,3.611
2011-10-04,374395,43111,42882,229,0.061
2011-10-11,373211,45017,52481,-7464,2.0
2011-10-18,371213,44484,45554,-1070,0.288
2011-10-25,380477,40046,51455,-11409,2.999
2011-11-01,386447,40794,54892,-14098,3.648
2011-11-08,372493,43657,51622,-7965,2.138
2011-11-15,365937,44965,48528,-3563,0.974
2011-11-22,385822,38437,55166,-16729,4.336
2011-11-29,367164,43080,57159,-14079,3.835
2011-12-06,362220,47790,57639,-9849,2.719
2011-12-13,363495,47941,57200,-9259,2.547
2011-12-20,354317,48557,59830,-11273,3.182
2011-12-27,334218,46953,49056,-2103,0.629
2012-01-03,322173,47288,36556,10732,3.331
2012-01-10,331673,51830,37233,14597,4.401
2012-01-17,345511,43228,50757,-7529,2.179
2012-01-24,366993,49951,62710,-12759,3.477
2012-01-31,376334,49819,67169,-17350,4.61
2012-02-07,369025,53246,55751,-2505,0.679
2012-02-14,371970,57049,42954,14095,3.789
2012-02-21,376981,64095,36466,27629,7.329
2012-02-28,350352,69155,31878,37277,10.64
2012-03-06,356431,61423,40350,21073,5.912
2012-03-13,387146,69527,44837,24690,6.377
2012-03-20,396345,73215,41118,32097,8.098
2012-03-27,414479,71815,42796,29019,7.001
2012-04-03,415254,76075,38142,37933,9.135
2012-04-10,451506,90929,36666,54263,12.018
2012-04-17,446749,84539,34289,50250,11.248
2012-04-24,417438,80349,37413,42936,10.286
2012-05-01,408130,72666,47258,25408,6.225
2012-05-08,431664,64765,53007,11758,2.724
2012-05-15,448414,50498,61634,-11136,2.483
2012-05-22,467023,45006,65932,-20926,4.481
2012-05-29,470165,41237,69699,-28462,6.054
2012-06-05,477593,38854,73126,-34272,7.176
2012-06-12,476068,44699,76399,-31700,6.659
2012-06-19,462321,47060,75535,-28475,6.159
2012-06-26,399083,41579,63367,-21788,5.46
2012-07-03,391287,45482,57420,-11938,3.051
2012-07-10,392116,50938,44451,6487,1.654
2012-07-17,399378,51125,41099,10026,2.51
2012-07-24,380006,44284,41315,2969,0.781
2012-07-31,375015,49314,39073,10241,2.731
2012-08-07,383411,49891,48370,1521,0.397
2012-08-14,385087,50171,35684,14487,3.762
2012-08-21,391665,61321,30269,31052,7.928
2012-08-28,391175,70014,23882,46132,11.793
2012-09-04,400783,74669,20492,54177,13.518
2012-09-11,381152,74345,21498,52847,13.865
2012-09-18,364847,66555,18787,47768,13.093
2012-09-25,341651,54472,19997,34475,10.091
2012-10-02,358453,45539,29741,15798,4.407
2012-10-09,380557,44620,38948,5672,1.49
2012-10-16,399354,40340,52309,-11969,2.997
2012-10-23,393432,39196,55816,-16620,4.224
2012-10-30,387813,42783,65604,-22821,5.885
2012-11-06,435951,40205,76058,-35853,8.224
2012-11-13,447855,37019,81159,-44140,9.856
2012-11-20,426242,33034,86455,-53421,12.533
2012-11-27,370218,36172,85327,-49155,13.277
2012-12-04,361309,39123,82248,-43125,11.936
2012-12-11,360381,44488,73094,-28606,7.938
2012-12-18,368699,44402,76910,-32508,8.817
2012-12-24,353164,42581,85005,-42424,12.013
2012-12-31,344337,41804,83404,-41600,12.081
2013-01-08,343794,41686,78702,-37016,10.767
2013-01-15,360034,41410,73905,-32495,9.026
2013-01-22,361600,51194,61190,-9996,2.764
2013-01-29,361369,55396,58110,-2714,0.751
2013-02-05,373905,61233,53814,7419,1.984
2013-02-12,381490,51938,63980,-12042,3.157
2013-02-19,372877,50884,64190,-13306,3.568
2013-02-26,355022,41732,83429,-41697,11.745
2013-03-05,361249,36795,91906,-55111,15.256
2013-03-12,365440,41428,92005,-50577,13.84
2013-03-19,381703,43900,93076,-49176,12.883
2013-03-26,377229,50592,82140,-31548,8.363
2013-04-02,383549,48554,81843,-33289,8.679
2013-04-09,407260,47243,90453,-43210,10.61
2013-04-16,408373,47873,90214,-42341,10.368
2013-04-23,404688,51033,84758,-33725,8.334
2013-04-30,375540,56200,81488,-25288,6.734
2013-05-07,382289,57002,78832,-21830,5.71
2013-05-14,381834,59451,72618,-13167,3.448
2013-05-21,391895,57989,68998,-11009,2.809
2013-05-28,396958,59758,65387,-5629,1.418
2013-06-04,407723,55144,76184,-21040,5.16
2013-06-11,407184,56741,75844,-19103,4.691
2013-06-18,393039,57945,79937,-21992,5.595
2013-06-25,363708,56232,84204,-27972,7.691
2013-07-02,367255,52789,88613,-35824,9.755
2013-07-09,367860,54186,92236,-38050,10.344
2013-07-16,378189,53065,89170,-36105,9.547
2013-07-23,382575,48865,96358,-47493,12.414
2013-07-30,366575,49912,93716,-43804,11.95
2013-08-06,356336,50558,105074,-54516,15.299
2013-08-13,355432,51639,99910,-48271,13.581
2013-08-20,340979,53638,88642,-35004,10.266
2013-08-27,326771,53645,71280,-17635,5.397
2013-09-03,319881,53182,68934,-15752,4.924
2013-09-10,322210,51228,68701,-17473,5.423
2013-09-17,327856,49200,71973,-22773,6.946
2013-09-24,332467,50466,75047,-24581,7.394
2013-10-01,346017,48616,75083,-26467,7.649
2013-10-08,345712,48609,74593,-25984,7.516
2013-10-15,348570,44196,71933,-27737,7.957
2013-10-22,364389,47571,68130,-20559,5.642
2013-10-29,367273,48695,67309,-18614,5.068
2013-11-05,371848,46154,65737,-19583,5.266
2013-11-12,377183,47164,70256,-23092,6.122
2013-11-19,382274,44772,77131,-32359,8.465
2013-11-26,359489,45410,72100,-26690,7.424
2013-12-03,367320,44319,80273,-35954,9.788
2013-12-10,374086,41772,83488,-41716,11.151
2013-12-17,379546,42982,84932,-41950,11.053
2013-12-24,372123,42621,86631,-44010,11.827
2013-12-31,361655,42385,89034,-46649,12.899
2014-01-07,372673,42885,92914,-50029,13.424
2014-01-14,392331,48965,109624,-60659,15.461
2014-01-21,405774,49664,114201,-64537,15.905
2014-01-28,406499,46854,109866,-63012,15.501
2014-02-04,400437,43925,103066,-59141,14.769
2014-02-11,379777,41886,90319,-48433,12.753
2014-02-18,384216,46355,79951,-33596,8.744
2014-02-25,333506,48793,66560,-17767,5.327
2014-03-04,338189,54030,58013,-3983,1.178
2014-03-11,346147,66233,40851,25382,7.333
2014-03-18,346861,73059,39586,33473,9.65
2014-03-25,344112,68068,46370,21698,6.306
2014-04-01,361712,64256,52392,11864,3.28
2014-04-08,376121,61189,50618,10571,2.811
2014-04-15,388997,66361,41681,24680,6.345
2014-04-22,373968,66782,37048,29734,7.951
2014-04-29,340784,69725,35002,34723,10.189
2014-05-06,354329,66296,43130,23166,6.538
2014-05-13,350380,68151,50071,18080,5.16
2014-05-20,357270,64159,62919,1240,0.347
2014-05-27,354371,65784,64407,1377,0.389
2014-06-03,380142,64135,78253,-14118,3.714
2014-06-10,392647,60815,80375,-19560,4.982
2014-06-17,392254,63486,78129,-14643,3.733
2014-06-24,364536,68788,63292,5496,1.508
2014-07-01,351650,72931,56125,16806,4.779
2014-07-08,357344,70239,61534,8705,2.436
2014-07-15,376430,66719,65927,792,0.21
2014-07-22,391228,65125,72796,-7671,1.961
2014-07-29,372256,67014,74450,-7436,1.998
2014-08-05,369890,68318,72013,-3695,0.999
2014-08-12,389769,65701,81210,-15509,3.979
2014-08-19,421935,66115,81270,-15155,3.592
2014-08-26,413470,63477,79172,-15695,3.796
2014-09-02,418653,65351,83381,-18030,4.307
2014-09-09,432643,64908,86208,-21300,4.923
2014-09-16,432875,67491,80946,-13455,3.108
2014-09-23,450686,68959,73989,-5030,1.116
2014-09-30,430974,67280,73268,-5988,1.389
2014-10-07,435950,66594,62725,3869,0.887
2014-10-14,451320,67931,63159,4772,1.057
2014-10-21,457896,70373,66532,3841,0.839
2014-10-28,454475,71024,57354,13670,3.008
2014-11-04,465741,72511,47845,24666,5.296
2014-11-11,456232,68488,57433,11055,2.423
2014-11-18,458159,68872,60605,8267,1.804
2014-11-25,407617,74588,53601,20987,5.149
2014-12-02,413809,72159,59820,12339,2.982
2014-12-09,406681,70912,58670,12242,3.01
2014-12-16,400467,71282,52464,18818,4.699
2014-12-23,388078,70926,50235,20691,5.332
2014-12-30,384384,78215,43168,35047,9.118
2015-01-06,385769,79754,41459,38295,9.927
2015-01-13,386062,84478,35308,49170,12.736
2015-01-20,392546,85848,33880,51968,13.239
2015-01-27,421112,75290,52836,22454,5.332
2015-02-03,447550,63571,66213,-2642,0.59
2015-02-10,429661,60603,53028,7575,1.763
2015-02-17,427947,68880,40717,28163,6.581
2015-02-24,395007,67452,42701,24751,6.266
2015-03-03,386889,79595,36130,43465,11.234
2015-03-10,396328,72039,51634,20405,5.149
2015-03-17,413076,65800,62108,3692,0.894
2015-03-24,412662,64502,60354,4148,1.005
2015-03-31,419039,66410,68358,-1948,0.465
2015-04-07,408666,69278,62261,7017,1.717
2015-04-14,408589,73148,55488,17660,4.322
2015-04-21,419094,70695,49046,21649,5.166
2015-04-28,410383,73354,56581,16773,4.087
2015-05-05,411477,82763,45825,36938,8.977
2015-05-12,424056,81623,40623,41000,9.669
2015-05-19,431604,73733,45977,27756,6.431
2015-05-26,432561,75950,47379,28571,6.605
2015-06-02,449051,86189,26559,59630,13.279
2015-06-09,463167,89587,24323,65264,14.091
2015-06-16,453141,79687,39994,39693,8.76
2015-06-23,436962,64514,45923,18591,4.255
2015-06-30,407470,69233,39486,29747,7.3
2015-07-07,396447,63231,45448,17783,4.486
2015-07-14,408733,64258,37565,26693,6.531
2015-07-21,410641,60662,43872,16790,4.089
2015-07-28,406200,56869,58099,-1230,0.303
2015-08-04,411438,57118,69515,-12397,3.013
2015-08-11,413322,59851,68165,-8314,2.012
2015-08-18,429846,65208,76524,-11316,2.633
2015-08-25,447591,65836,74843,-9007,2.012
2015-09-01,441807,71385,78865,-7480,1.693
2015-09-08,457841,67663,79173,-11510,2.514
2015-09-15,466092,68048,85935,-17887,3.838
2015-09-22,475547,68453,87249,-18796,3.953
2015-09-29,449963,64425,67719,-3294,0.732
2015-10-06,455222,67984,54680,13304,2.923
2015-10-13,470365,68577,50034,18543,3.942
2015-10-20,476935,73777,48595,25182,5.28
2015-10-27,484197,68866,48360,20506,4.235
2015-11-03,503883,63963,50325,13638,2.707
2015-11-10,517952,63914,63299,615,0.119
2015-11-17,515991,67040,63946,3094,0.6
2015-11-24,476706,72024,50489,21535,4.517
2015-12-01,479984,75770,35232,40538,8.446
2015-12-08,474295,75521,13055,62466,13.17
2015-12-15,480175,83089,10632,72457,15.09
2015-12-22,457235,84851,19568,65283,14.278
2015-12-29,425727,79996,19101,60895,14.304
2016-01-05,424762,74774,27394,47380,11.154
2016-01-12,443192,69874,37027,32847,7.411
2016-01-19,451196,70681,31134,39547,8.765
2016-01-26,450610,66829,18280,48549,10.774
2016-02-02,459602,71814,21403,50411,10.968
2016-02-09,460218,72545,25284,47261,10.269
2016-02-16,467318,78893,21221,57672,12.341
2016-02-23,446568,80075,29587,50488,11.306
2016-03-01,421163,75301,33740,41561,9.868
2016-03-08,424624,72100,33008,39092,9.206
2016-03-15,467437,99347,24439,74908,16.025
2016-03-22,507806,119675,20335,99340,19.563
2016-03-29,510217,124764,19109,105655,20.708
2016-04-05,543095,133220,24501,108719,20.018
2016-04-12,533999,127344,30903,96441,18.06
2016-04-19,555782,119858,27133,92725,16.684
2016-04-26,483471,113379,18978,94401,19.526
2016-05-03,461048,99662,28710,70952,15.389
2016-05-10,455419,92385,24052,68333,15.004
2016-05-17,456108,89535,19539,69996,15.346
2016-05-24,457478,76802,30393,46409,10.145
2016-05-31,467378,75941,38933,37008,7.918
2016-06-07,467423,77666,36938,40728,8.713
2016-06-14,460812,82550,29680,52870,11.473
2016-06-21,447890,69508,34668,34840,7.779
2016-06-28,404603,59145,38947,20198,4.992
2016-07-05,401688,52630,50746,1884,0.469
2016-07-12,397428,50374,49815,559,0.141
2016-07-19,406016,49168,53246,-4078,1.004
2016-07-26,405977,47219,64437,-17218,4.241
2016-08-02,401307,45354,62184,-16830,4.194
2016-08-09,403604,54184,46983,7201,1.784
2016-08-16,426357,65927,26872,39055,9.16
2016-08-23,461766,93310,17312,75998,16.458
2016-08-30,438276,104366,19063,85303,19.463
2016-09-06,439954,101886,19520,82366,18.722
2016-09-13,438014,95964,25736,70228,16.033
2016-09-20,436602,98085,15844,82241,18.837
2016-09-27,453404,109826,15634,94192,20.774
2016-10-04,453671,108678,15936,92742,20.443
2016-10-11,472433,102465,20656,81809,17.317
2016-10-18,492761,116267,15006,101261,20.55
2016-10-25,507534,125981,10827,115154,22.689
2016-11-01,517984,136973,10430,126543,24.43
2016-11-08,515135,133472,14718,118754,23.053
2016-11-15,475835,110731,13090,97641,20.52
2016-11-22,472333,108628,13095,95533,20.226
2016-11-29,452674,117774,5823,111951,24.731
2016-12-06,467320,117369,7509,109860,23.509
2016-12-13,437906,114375,13008,101367,23.148
2016-12-20,438278,114361,16474,97887,22.334
2016-12-27,406645,102895,17373,85522,21.031
2017-01-03,400483,91135,20001,71134,17.762
2017-01-10,408014,93697,15072,78625,19.27
2017-01-17,426740,100528,15245,85283,19.985
2017-01-24,441762,109403,13498,95905,21.71
2017-01-31,444890,93271,26296,66975,15.054
2017-02-07,436421,82450,19598,62852,14.402
2017-02-14,416903,83621,15003,68618,16.459
2017-02-21,435295,76976,32078,44898,10.314
2017-02-28,395607,66455,39409,27046,6.837
2017-03-07,400102,67134,40770,26364,6.589
2017-03-14,418133,62690,61906,784,0.188
2017-03-21,442204,60532,85697,-25165,5.691
2017-03-28,441972,63343,83091,-19748,4.468
2017-04-04,470552,58378,97174,-38796,8.245
2017-04-11,475103,56413,107119,-50706,10.673
2017-04-18,482545,59246,106542,-47296,9.801
2017-04-25,452008,68788,105802,-37014,8.189
2017-05-02,460786,72146,101534,-29388,6.378
2017-05-09,449668,77807,90658,-12851,2.858
2017-05-16,449112,78607,84615,-6008,1.338
2017-05-23,458168,77252,85873,-8621,1.882
2017-05-30,474362,74632,96945,-22313,4.704
2017-06-06,501335,75910,110211,-34301,6.842
2017-06-13,463085,77656,94496,-16840,3.636
2017-06-20,450697,78200,73431,4769,1.058
2017-06-27,407615,73624,63113,10511,2.579
2017-07-03,404306,71175,51457,19718,4.877
2017-07-11,432122,78743,35747,42996,9.95
2017-07-18,432337,82243,33295,48948,11.322
2017-07-25,426819,91200,28572,62628,14.673
2017-08-01,438149,96373,28460,67913,15.5
2017-08-08,443731,96959,31944,65015,14.652
2017-08-15,449596,86667,40637,46030,10.238
2017-08-22,454813,80487,35883,44604,9.807
2017-08-29,441516,82924,16053,66871,15.146
2017-09-05,458084,101072,12438,88634,19.349
2017-09-12,472864,113472,13037,100435,21.24
2017-09-19,473144,110516,17646,92870,19.628
2017-09-26,465056,99638,24009,75629,16.262
2017-10-03,450331,73997,43281,30716,6.821
2017-10-10,461218,71248,48116,23132,5.015
2017-10-17,472962,73492,48567,24925,5.27
2017-10-24,477784,78427,42814,35613,7.454
2017-10-31,481860,78130,34080,44050,9.142
2017-11-07,502405,84231,29868,54363,10.821
2017-11-14,508238,88658,31983,56675,11.151
2017-11-21,515462,83315,35651,47664,9.247
2017-11-28,485484,75987,49589,26398,5.437
2017-12-05,501657,70231,56552,13679,2.727
2017-12-12,494301,78257,65548,12709,2.571
2017-12-19,500990,77660,68527,9133,1.823
2017-12-26,475641,74502,71096,3406,0.716
2018-01-02,468013,73533,70159,3374,0.721
2018-01-09,475819,77527,65615,11912,2.503
2018-01-16,498111,70740,76572,-5832,1.171
2018-01-23,540168,71321,92817,-21496,3.98
2018-01-30,536440,70699,87287,-16588,3.092
2018-02-06,525277,73950,76638,-2688,0.512
2018-02-13,539982,71251,84881,-13630,2.524
2018-02-20,539130,68289,95424,-27135,5.033
2018-02-27,491114,72597,81944,-9347,1.903
2018-03-06,514235,73935,82981,-9046,1.759
2018-03-13,517069,69391,90612,-21221,4.104
2018-03-20,526434,68125,93045,-24920,4.734
2018-03-27,547098,65798,101914,-36116,6.601
2018-04-03,545053,69856,92298,-22442,4.117
2018-04-10,572007,68685,101484,-32799,5.734
2018-04-17,558796,68316,109143,-40827,7.306
2018-04-24,518430,67614,120340,-52726,10.17
2018-05-01,532786,65706,139246,-73540,13.803
2018-05-08,538981,68044,135993,-67949,12.607
2018-05-15,536377,71415,126857,-55442,10.336
2018-05-22,542209,68812,116061,-47249,8.714
2018-05-29,536461,67839,116814,-48975,9.129
2018-06-05,534745,65993,123603,-57610,10.773
2018-06-12,533174,62527,136272,-73745,13.831
2018-06-19,562689,58871,152010,-93139,16.552
2018-06-26,524465,62225,152405,-90180,17.195
2018-07-03,520902,62538,151843,-89305,17.144
2018-07-10,526870,61636,147001,-85365,16.202
2018-07-17,550453,62129,152340,-90211,16.389
2018-07-24,565582,57750,147702,-89952,15.904
2018-07-31,542097,54088,145859,-91771,16.929
2018-08-07,552033,56106,147487,-91381,16.554
2018-08-14,571765,56422,153546,-97124,16.987
2018-08-21,572391,54161,149370,-95209,16.634
2018-08-28,558494,58594,145079,-86485,15.485
2018-09-04,556714,57598,145627,-88029,15.812
2018-09-11,596612,53420,150776,-97356,16.318
2018-09-18,638655,48941,158891,-109950,17.216
2018-09-25,617858,53578,139360,-85782,13.884
2018-10-02,587068,61594,112925,-51331,8.744
2018-10-09,569608,59271,100389,-41118,7.219
2018-10-16,565711,61063,94169,-33106,5.852
2018-10-23,564666,63235,94783,-31548,5.587
2018-10-30,579309,57340,112339,-54999,9.494
2018-11-06,590032,53242,112408,-59166,10.028
2018-11-13,610322,52107,122263,-70156,11.495
2018-11-20,611161,50610,129855,-79245,12.966
2018-11-27,565612,50792,131166,-80374,14.21
2018-12-04,554819,57940,117891,-59951,10.806
2018-12-11,533381,58284,104905,-46621,8.741
2018-12-18,508126,55161,102959,-47798,9.407
2018-12-24,492960,50515,102017,-51502,10.448
2018-12-31,497575,49288,109360,-60072,12.073
2019-01-08,500053,49979,100160,-50181,10.035
2019-01-15,514594,53067,101229,-48162,9.359
2019-01-22,532892,57701,89067,-31366,5.886
2019-01-29,526650,69161,65967,3194,0.606
2019-02-05,535293,79607,51047,28560,5.335
2019-02-12,554377,83593,49134,34459,6.216
2019-02-19,545501,80405,50538,29867,5.475
2019-02-26,511919,75017,51736,23281,4.548
2019-03-05,515328,73929,52891,21038,4.082
2019-03-12,500032,76288,57326,18962,3.792
2019-03-19,510093,73898,63522,10376,2.034
2019-03-26,512043,69677,77997,-8320,1.625
2019-04-02,511357,64012,90973,-26961,5.272
2019-04-09,511702,67566,99175,-31609,6.177
2019-04-16,505393,66470,100390,-33920,6.712
2019-04-23,522949,63856,114493,-50637,9.683
2019-04-30,509696,64716,122788,-58072,11.393
2019-05-07,536990,64509,135359,-70850,13.194
2019-05-14,580896,65361,145767,-80406,13.842
2019-05-21,586552,70516,139456,-68940,11.753
2019-05-28,581773,69296,131520,-62224,10.696
2019-06-04,550353,68613,124424,-55811,10.141
2019-06-11,520712,65810,119613,-53803,10.333
2019-06-18,500234,61260,104006,-42746,8.545
2019-06-25,453669,62651,98620,-35969,7.928
2019-07-02,439117,63863,100146,-36283,8.263
2019-07-09,446962,64131,94800,-30669,6.862
2019-07-16,457869,65484,96678,-31194,6.813
2019-07-23,469660,63699,102874,-39175,8.341
2019-07-30,450640,65316,89719,-24403,5.415
2019-08-06,468719,64560,101635,-37075,7.91
2019-08-13,485712,72788,62459,10329,2.127
2019-08-20,500135,70689,67707,2982,0.596
2019-08-27,496033,64658,79181,-14523,2.928
2019-09-03,507823,66722,79453,-12731,2.507
2019-09-10,526548,64853,83959,-19106,3.629
2019-09-17,527411,71174,51243,19931,3.779
2019-09-24,526593,74451,52052,22399,4.254
2019-10-01,512020,67783,56310,11473,2.241
2019-10-08,505406,71665,41942,29723,5.881
2019-10-15,521603,79258,35801,43457,8.331
2019-10-22,533010,94855,27235,67620,12.686
2019-10-29,549304,103299,27946,75353,13.718
2019-11-05,577583,116446,31803,84643,14.655
2019-11-12,582197,120101,32004,88097,15.132
2019-11-19,554290,109972,27616,82356,14.858
2019-11-26,552038,106331,39447,66884,12.116
2019-12-03,560031,102112,42934,59178,10.567
2019-12-10,550400,110872,33202,77670,14.112
2019-12-17,561425,127727,24387,103340,18.407
2019-12-24,561516,139657,20237,119420,21.267
2019-12-31,540191,135270,23087,112183,20.767
2020-01-07,558935,136382,25520,110862,19.835
2020-01-14,582432,136631,23720,112911,19.386
2020-01-21,589509,126089,24830,101259,17.177
2020-01-28,592545,118232,21494,96738,16.326
2020-02-04,573527,89713,21828,67885,11.836
2020-02-11,558381,80746,28077,52669,9.432
2020-02-18,561772,75597,35969,39628,7.054
2020-02-25,535217,65541,42493,23048,4.306
2020-03-03,498604,57238,42248,14990,3.006
2020-03-10,504736,56377,44917,11460,2.27
2020-03-17,520002,43772,42060,1712,0.329
2020-03-24,511224,41017,41763,-746,0.146
2020-03-31,500693,38831,44184,-5353,1.069
2020-04-07,511947,41703,38995,2708,0.529
2020-04-14,526687,38726,40822,-2096,0.398
2020-04-21,520367,37671,49228,-11557,2.221
2020-04-28,506840,40049,51955,-11906,2.349
2020-05-05,500798,41488,48242,-6754,1.349
2020-05-12,510840,43776,51641,-7865,1.54
2020-05-19,515336,51136,48455,2681,0.52
2020-05-26,519032,50925,46941,3984,0.768
2020-06-02,525264,54772,43396,11376,2.166
2020-06-09,518021,50669,50725,-56,0.011
2020-06-16,508744,47827,52613,-4786,0.941
2020-06-23,506222,49772,50493,-721,0.142
2020-06-30,457565,54866,54019,847,0.185
2020-07-07,471406,62780,43362,19418,4.119
2020-07-14,467484,57515,47317,10198,2.181
2020-07-21,481302,69864,32967,36897,7.666
2020-07-28,460732,69135,31586,37549,8.15
2020-08-04,470078,80998,32665,48333,10.282
2020-08-11,476630,80465,28322,52143,10.94
2020-08-18,489389,81535,24011,57524,11.754
2020-08-25,486373,88235,20545,67690,13.917
2020-09-01,492985,94635,13078,81557,16.544
2020-09-08,510938,96009,10710,85299,16.695
2020-09-15,523398,108102,13538,94564,18.067
2020-09-22,528194,113818,12116,101702,19.255
2020-09-29,517491,106555,12457,94098,18.184
2020-10-06,525540,96165,15171,80994,15.412
2020-10-13,529660,93067,10879,82188,15.517
2020-10-20,526968,93967,11933,82034,15.567
2020-10-27,532679,103634,9208,94426,17.727
2020-11-03,535163,98210,9159,89051,16.64
2020-11-10,553732,105687,8576,97111,17.538
2020-11-17,576395,112277,8499,103778,18.005
2020-11-24,536745,112890,7549,105341,19.626
2020-12-01,545609,111305,6590,104715,19.192
2020-12-08,559365,102654,13591,89063,15.922
2020-12-15,578648,111018,13299,97719,16.887
2020-12-21,588977,114093,12840,101253,17.191
2020-12-29,557576,120817,7828,112989,20.264
2021-01-05,571571,121116,8199,112917,19.756
2021-01-12,568408,106876,13340,93536,16.456
2021-01-19,559232,103285,12586,90699,16.218
2021-01-26,575294,118776,11442,107334,18.657
2021-02-02,581377,118945,13015,105930,18.221
2021-02-09,601413,121840,11448,110392,18.355
2021-02-16,626841,120231,9835,110396,17.611
2021-02-23,551290,121662,9017,112645,20.433
2021-03-02,548774,117528,9447,108081,19.695
2021-03-09,590495,113826,14252,99574,16.863
2021-03-16,604977,116760,18074,98686,16.312
2021-03-23,615294,115303,21326,93977,15.274
2021-03-30,589479,108796,27956,80840,13.714
2021-04-06,603836,102507,25470,77037,12.758
2021-04-13,598089,104578,23413,81165,13.571
2021-04-20,622088,111746,21754,89992,14.466
2021-04-27,572191,111556,18969,92587,16.181
2021-05-04,585496,108149,20644,87505,14.945
2021-05-11,602999,104170,18320,85850,14.237
2021-05-18,623254,100828,17608,83220,13.353
2021-05-25,619928,102989,17662,85327,13.764
2021-06-01,650311,106687,20603,86084,13.237
2021-06-08,667461,97425,16105,81320,12.183
2021-06-15,662386,86192,18966,67226,10.149
2021-06-22,631820,69664,17512,52152,8.254
2021-06-29,577346,69818,21644,48174,8.344
2021-07-06,575457,69447,21273,48174,8.371
2021-07-13,575087,71642,22715,48927,8.508
2021-07-20,567643,76230,19083,57147,10.067
2021-07-27,508178,80620,19358,61262,12.055
2021-08-03,504327,84986,20299,64687,12.826
2021-08-10,501924,83650,20108,63542,12.66
2021-08-17,502103,86883,17788,69095,13.761
2021-08-24,495595,83711,16724,66987,13.516
2021-08-31,470377,77703,22397,55306,11.758
2021-09-07,460098,75114,22034,53080,11.537
2021-09-14,445998,71620,24526,47094,10.559
2021-09-21,445944,68475,29495,38980,8.741
2021-09-28,438193,69233,21743,47490,10.838
2021-10-05,448531,86867,11689,75178,16.761
2021-10-12,460957,87083,14099,72984,15.833
2021-10-19,481777,95324,13113,82211,17.064
2021-10-26,478248,99885,14254,85631,17.905
2021-11-02,488744,101441,12693,88748,18.158
2021-11-09,484856,89994,17389,72605,14.975
2021-11-16,495844,91121,14909,76212,15.37
2021-11-23,498334,94904,12550,82354,16.526
2021-11-30,436518,82530,18170,64360,14.744
2021-12-07,425461,75120,16292,58828,13.827
2021-12-14,451435,65328,20545,44783,9.92
2021-12-21,456215,62160,23082,39078,8.566
2021-12-28,419844,64328,18934,45394,10.812
2022-01-04,422697,72005,18817,53188,12.583
2022-01-11,430663,75189,19282,55907,12.982
2022-01-18,434799,78122,19914,58208,13.387
2022-01-25,455930,85958,17185,68773,15.084
2022-02-01,496168,95553,15077,80476,16.22
2022-02-08,484568,90249,17467,72782,15.02
2022-02-15,486365,86865,16484,70381,14.471
2022-02-22,457440,92853,13653,79200,17.314
2022-03-01,439766,92532,11101,81431,18.517
2022-03-08,418231,88983,3314,85669,20.484
2022-03-15,414017,91336,2165,89171,21.538
2022-03-22,415464,87821,3743,84078,20.237
2022-03-29,400221,82827,4226,78601,19.639
2022-04-05,410957,81630,4880,76750,18.676
2022-04-12,432997,86136,2073,84063,19.414
2022-04-19,471333,99507,3419,96088,20.386
2022-04-26,440799,102359,4676,97683,22.16
2022-05-03,425185,90639,4996,85643,20.143
2022-05-10,437582,93251,4875,88376,20.196
2022-05-17,447084,92173,5936,86237,19.289
2022-05-24,436457,82179,13185,68994,15.808
2022-05-31,446521,80340,15879,64461,14.436
2022-06-07,471053,83121,14298,68823,14.61
2022-06-14,453471,79428,16432,62996,13.892
2022-06-21,451454,67960,17074,50886,11.272
2022-06-28,404637,57643,24038,33605,8.305
2022-07-05,414025,51081,26152,24929,6.021
2022-07-12,427432,44849,25972,18877,4.416
2022-07-19,436352,43415,25571,17844,4.089
2022-07-26,414842,43249,28341,14908,3.594
2022-08-02,427708,44648,22507,22141,5.177
2022-08-09,457240,46151,23941,22210,4.857
2022-08-16,462872,51559,18324,33235,7.18
2022-08-23,472042,57651,15443,42208,8.942
2022-08-30,439383,61705,12519,49186,11.194
2022-09-06,439474,60272,16290,43982,10.008
2022-09-13,449801,67266,11996,55270,12.288
2022-09-20,454576,68867,10557,58310,12.827
2022-09-27,447185,70584,12167,58417,13.063
2022-10-04,452583,73116,10362,62754,13.866
2022-10-11,439056,70860,9876,60984,13.89
2022-10-18,459121,83172,8198,74974,16.33
2022-10-25,482923,103802,8641,95161,19.705
2022-11-01,493168,108978,8860,100118,20.301
2022-11-08,518361,111483,6273,105210,20.297
2022-11-15,536578,115747,5376,110371,20.569
2022-11-22,520069,109222,8948,100274,19.281
2022-11-29,479986,115566,10063,105503,21.98
2022-12-06,485549,81548,18964,62584,12.889
2022-12-13,464030,73180,19831,53349,11.497
2022-12-20,445456,73478,15348,58130,13.05
2022-12-27,403106,77360,11773,65587,16.27
2023-01-03,406954,77497,13735,63762,15.668
2023-01-10,408665,68982,14368,54614,13.364
2023-01-17,412731,68600,14592,54008,13.086
2023-01-24,442965,58704,22743,35961,8.118
2023-01-31,461965,56423,25199,31224,6.759
2023-02-07,499140,55855,33360,22495,4.507
2023-02-14,505256,57756,35433,22323,4.418
2023-02-21,507077,64450,30149,34301,6.764
2023-02-28,463290,60159,32066,28093,6.064
2023-03-07,479009,58065,37539,20526,4.285
2023-03-14,501748,53212,54401,-1189,0.237
2023-03-21,496457,52159,57877,-5718,1.152
2023-03-28,506284,45786,58245,-12459,2.461
2023-04-04,525578,46299,56884,-10585,2.014
2023-04-11,528132,46481,59047,-12566,2.379
2023-04-18,523252,46090,61833,-15743,3.009
2023-04-25,495888,49309,68864,-19555,3.943
2023-05-02,508660,53844,77578,-23734,4.666
2023-05-09,524176,59676,73160,-13484,2.572
2023-05-16,576435,50354,86735,-36381,6.311
2023-05-23,610653,51057,87934,-36877,6.039
2023-05-30,613532,50404,87853,-37449,6.104
2023-06-06,610612,54345,72651,-18306,2.998
2023-06-13,607403,56718,47970,8748,1.44
2023-06-20,618592,56650,26833,29817,4.82
2023-06-27,559720,61585,22834,38751,6.923
2023-07-03,580836,64161,22242,41919,7.217
2023-07-11,603767,71442,21870,49572,8.21
2023-07-18,605479,70075,25161,44914,7.418
2023-07-25,565754,79224,25034,54190,9.578
2023-08-01,549860,79096,29619,49477,8.998
2023-08-08,552558,75245,28722,46523,8.42
2023-08-15,560046,75496,28828,46668,8.333
2023-08-22,560340,84536,29459,55077,9.829
2023-08-29,525448,86733,28416,58317,11.099
2023-09-05,512253,85049,29890,55159,10.768
2023-09-12,522284,73584,32719,40865,7.824
2023-09-19,509218,74065,27001,47064,9.242
2023-09-26,483878,64918,29868,35050,7.244
2023-10-03,467886,66027,24643,41384,8.845
2023-10-10,473052,59848,33881,25967,5.489
2023-10-17,487860,56587,35858,20729,4.249
2023-10-24,525697,56626,45103,11523,2.192
2023-10-31,542089,59436,54941,4495,0.829
2023-11-07,563612,56783,67135,-10352,1.837
2023-11-14,577788,62386,68983,-6597,1.142
2023-11-21,565166,62877,65708,-2831,0.501
2023-11-28,511262,59221,63941,-4720,0.923
2023-12-05,510073,52061,69963,-17902,3.51
2023-12-12,496970,48102,70686,-22584,4.544
2023-12-19,507402,44589,76524,-31935,6.294
2023-12-26,504227,41818,91471,-49653,9.847
2024-01-02,521118,47471,98025,-50554,9.701
2024-01-09,542231,51476,98084,-46608,8.596
2024-01-16,572643,55378,102389,-47011,8.209
2024-01-23,593641,57267,101972,-44705,7.531
2024-01-30,612939,58257,112675,-54418,8.878
2024-02-06,631196,64426,108651,-44225,7.007
2024-02-13,603973,69017,104457,-35440,5.868
2024-02-20,604371,61785,114626,-52841,8.743
2024-02-27,558317,62506,114835,-52329,9.373
2024-03-05,582934,61441,123914,-62473,10.717
2024-03-12,595795,74644,108054,-33410,5.608
2024-03-19,621449,73248,87996,-14748,2.373
2024-03-26,623074,80137,79186,951,0.153
2024-04-02,638880,86744,78361,8383,1.312
2024-04-09,627222,83371,87499,-4128,0.658
2024-04-16,650951,65306,118601,-53295,8.187
2024-04-23,624397,66508,116036,-49528,7.932
2024-04-30,592947,65136,132018,-66882,11.28
2024-05-07,591931,67785,133491,-65706,11.1
2024-05-14,591019,65266,127078,-61812,10.459
2024-05-21,588606,61827,108348,-46521,7.904
2024-05-28,597248,62760,104604,-41844,7.006
2024-06-04,615280,58385,116075,-57690,9.376
2024-06-11,614955,55812,131656,-75844,12.333
