Report_Date,Open_Interest_All,MM_Long_All,MM_Short_All,Net_Position,Percent_of_OpenInterest
2006-06-13,484407,40085,42608,-2523,0.521
2006-06-20,470526,36917,52192,-15275,3.246
2006-06-27,414948,34717,68052,-33335,8.034
2006-07-03,410024,39376,44532,-5156,1.257
2006-07-11,427561,45254,39108,6146,1.437
2006-07-18,416774,41314,39321,1993,0.478
2006-07-25,398164,42451,48574,-6123,1.538
2006-08-01,414997,43505,69211,-25706,6.194
2006-08-08,418437,42194,80996,-38802,9.273
2006-08-15,426421,38006,81780,-43774,10.265
2006-08-22,443178,37595,83310,-45715,10.315
2006-08-29,433571,35858,83107,-47249,10.898
2006-09-05,435205,37300,83024,-45724,10.506
2006-09-12,442040,36913,88062,-51149,11.571
2006-09-19,446428,35464,87535,-52071,11.664
2006-09-26,450924,31348,84868,-53520,11.869
2006-10-03,470218,29847,85112,-55265,11.753
2006-10-10,472253,36698,65401,-28703,6.078
2006-10-17,506020,45970,46175,-205,0.041
2006-10-24,495308,48737,28243,20494,4.138
2006-10-31,456696,58666,21848,36818,8.062
2006-11-07,488685,64018,20031,43987,9.001
2006-11-14,501704,69471,21072,48399,9.647
2006-11-21,504744,67057,21612,45445,9.004
2006-11-28,529498,71653,20247,51406,9.708
2006-12-05,538390,66681,21352,45329,8.419
2006-12-12,550854,73942,20228,53714,9.751
2006-12-19,546420,68823,20227,48596,8.894
2006-12-26,496168,70209,19197,51012,10.281
2007-01-03,497953,77008,19695,57313,11.51
2007-01-09,498726,77534,22547,54987,11.025
2007-01-16,541420,85955,21109,64846,11.977
2007-01-23,570881,98365,20779,77586,13.591
2007-01-30,571574,99205,17234,81971,14.341
2007-02-06,607699,109325,12976,96349,15.855
2007-02-13,628858,107747,12793,94954,15.099
2007-02-20,660578,111199,14380,96819,14.657
2007-02-27,622588,111104,14346,96758,15.541
2007-03-06,608592,84982,18068,66914,10.995
2007-03-13,610320,89842,11221,78621,12.882
2007-03-20,629459,94508,12213,82295,13.074
2007-03-27,628757,93994,11713,82281,13.086
2007-04-03,648432,97599,11594,86005,13.264
2007-04-10,637031,83606,14892,68714,10.787
2007-04-17,641764,73156,18216,54940,8.561
2007-04-24,551120,63721,21092,42629,7.735
2007-05-01,550492,74842,13764,61078,11.095
2007-05-08,549681,72441,15482,56959,10.362
2007-05-15,591999,91973,5981,85992,14.526
2007-05-22,632012,116380,6425,109955,17.398
2007-05-29,661839,125083,8487,116596,17.617
2007-06-05,723283,141846,6921,134925,18.655
2007-06-12,722314,137850,8323,129527,17.932
2007-06-19,736533,135725,4405,131320,17.829
2007-06-26,659065,121671,5203,116468,17.672
2007-07-03,682760,130042,9486,120556,17.657
2007-07-10,720536,146331,10705,135626,18.823
2007-07-17,724567,129370,10720,118650,16.375
2007-07-24,699603,115684,11738,103946,14.858
2007-07-31,659871,108666,12267,96399,14.609
2007-08-07,652677,107309,8413,98896,15.152
2007-08-14,657415,116120,11539,104581,15.908
2007-08-21,648191,93173,14882,78291,12.078
2007-08-28,638126,105877,11237,94640,14.831
2007-09-04,659541,112780,8659,104121,15.787
2007-09-11,679157,117087,9370,107717,15.86
2007-09-18,737980,127829,8662,119167,16.148
2007-09-25,748040,131280,5498,125782,16.815
2007-10-02,755837,129234,8207,121027,16.012
2007-10-09,766273,132413,5989,126424,16.499
2007-10-16,784454,135193,6276,128917,16.434
2007-10-23,785306,136935,4931,132004,16.809
2007-10-30,696084,138682,5059,133623,19.196
2007-11-06,718137,151563,4512,147051,20.477
2007-11-13,740331,150437,3951,146486,19.787
2007-11-20,764735,158249,2502,155747,20.366
2007-11-27,749085,148424,5639,142785,19.061
2007-12-04,760077,152873,4163,148710,19.565
2007-12-11,774709,156679,1753,154926,19.998
2007-12-18,779134,148194,2066,146128,18.755
2007-12-24,738955,150538,1722,148816,20.139
2007-12-31,733990,146007,3218,142789,19.454
2008-01-08,765842,144326,1821,142505,18.608
2008-01-15,791022,144275,3037,141238,17.855
2008-01-22,783498,135606,4926,130680,16.679
2008-01-29,793158,140285,3387,136898,17.26
2008-02-05,838106,149907,3511,146396,17.467
2008-02-12,841245,143231,3518,139713,16.608
2008-02-19,878378,148118,4718,143400,16.326
2008-02-26,819428,140383,2468,137915,16.831
2008-03-04,812030,127435,4686,122749,15.116
2008-03-11,791692,117422,5492,111930,14.138
2008-03-18,806666,118096,7829,110267,13.669
2008-03-25,789241,116614,7982,108632,13.764
2008-04-01,770413,107694,12490,95204,12.358
2008-04-08,756598,108271,5512,102759,13.582
2008-04-15,778709,113393,3825,109568,14.07
2008-04-22,775412,120313,4204,116109,14.974
2008-04-29,661079,116842,7498,109344,16.54
2008-05-06,642804,115651,4707,110944,17.259
2008-05-13,649502,118278,6180,112098,17.259
2008-05-20,644202,119364,6497,112867,17.52
2008-05-27,648088,116589,6315,110274,17.015
2008-06-03,664023,122902,4965,117937,17.761
2008-06-10,699193,131553,7507,124046,17.741
2008-06-17,733117,128535,6937,121598,16.586
2008-06-24,631526,123611,8845,114766,18.173
2008-07-01,654425,128315,8865,119450,18.253
2008-07-08,644040,117134,7626,109508,17.003
2008-07-15,631462,117970,7341,110629,17.52
2008-07-22,607051,104660,9897,94763,15.61
2008-07-29,552608,94997,5870,89127,16.128
2008-08-05,547771,93037,6238,86799,15.846
2008-08-12,561309,85446,11234,74212,13.221
2008-08-19,566097,81583,10189,71394,12.612
2008-08-26,544315,84798,8050,76748,14.1
2008-09-02,534851,82481,6619,75862,14.184
2008-09-09,547022,70521,16454,54067,9.884
2008-09-16,562180,59590,16120,43470,7.732
2008-09-23,538390,61054,13596,47458,8.815
2008-09-30,555265,52828,15185,37643,6.779
2008-10-07,575501,53072,13052,40020,6.954
2008-10-14,589260,43907,17906,26001,4.412
2008-10-21,553469,38483,17428,21055,3.804
2008-10-28,419138,40067,10456,29611,7.065
2008-11-04,412958,43908,7510,36398,8.814
2008-11-11,425124,40815,10702,30113,7.083
2008-11-18,423940,41173,10673,30500,7.194
2008-11-25,427552,45208,12593,32615,7.628
2008-12-02,440156,41823,17693,24130,5.482
2008-12-09,449615,42672,18297,24375,5.421
2008-12-16,442111,42353,19679,22674,5.129
2008-12-22,420278,42237,17585,24652,5.866
2008-12-30,379052,44542,13024,31518,8.315
2009-01-06,395931,47349,12264,35085,8.861
2009-01-13,413270,53767,11353,42414,10.263
2009-01-20,442483,53423,15731,37692,8.518
2009-01-27,458782,57644,14390,43254,9.428
2009-02-03,459352,57233,17110,40123,8.735
2009-02-10,461414,59717,12525,47192,10.228
2009-02-17,469299,52520,22427,30093,6.412
2009-02-24,399233,49892,29243,20649,5.172
2009-03-03,398374,46562,34270,12292,3.086
2009-03-10,403707,44806,31679,13127,3.252
2009-03-17,421601,48777,28238,20539,4.872
2009-03-24,452203,60486,17841,42645,9.43
2009-03-31,446942,61399,16846,44553,9.968
2009-04-07,476888,77288,9930,67358,14.124
2009-04-14,512878,87406,8129,79277,15.457
2009-04-21,537107,98533,8441,90092,16.774
2009-04-28,503822,91260,10343,80917,16.061
2009-05-05,548869,105438,6141,99297,18.091
2009-05-12,568273,107773,4275,103498,18.213
2009-05-19,605299,112876,4465,108411,17.91
2009-05-26,623825,118466,5029,113437,18.184
2009-06-02,642081,118852,5813,113039,17.605
2009-06-09,660051,124114,6444,117670,17.827
2009-06-16,659287,116400,6514,109886,16.667
2009-06-23,661897,109235,6252,102983,15.559
2009-06-30,578217,109170,7928,101242,17.509
2009-07-07,576683,88662,9911,78751,13.656
2009-07-14,575545,81221,17956,63265,10.992
2009-07-21,571460,76517,17835,58682,10.269
2009-07-28,528948,78653,15086,63567,12.018
2009-08-04,560711,96497,10812,85685,15.281
2009-08-11,579236,107518,6620,100898,17.419
2009-08-18,567153,86899,7910,78989,13.927
2009-08-25,550674,83706,9854,73852,13.411
2009-09-01,562660,80950,20499,60451,10.744
2009-09-08,581189,73655,27763,45892,7.896
2009-09-15,595306,80041,29408,50633,8.505
2009-09-22,598079,72695,34554,38141,6.377
2009-09-29,589428,71715,30452,41263,7.001
2009-10-06,607932,77581,39478,38103,6.268
2009-10-13,635222,88399,16174,72225,11.37
2009-10-20,627886,97800,18697,79103,12.598
2009-10-27,546260,96327,19105,77222,14.136
2009-11-03,538228,107140,11935,95205,17.689
2009-11-09,535638,89981,17985,71996,13.441
2009-11-17,560171,104733,14891,89842,16.038
2009-11-24,587345,120090,8399,111691,19.016
2009-12-01,608589,120126,7835,112291,18.451
2009-12-08,611896,124332,13130,111202,18.173
2009-12-15,622997,128698,16154,112544,18.065
2009-12-22,606444,94720,26334,68386,11.277
2009-12-29,526575,92554,22948,69606,13.219
2010-01-05,533998,111171,22875,88296,16.535
2010-01-12,554547,95701,36562,59139,10.664
2010-01-19,578356,84955,41718,43237,7.476
2010-01-26,572952,81786,49650,32136,5.609
2010-02-02,603452,78247,56794,21453,3.555
2010-02-09,610352,71672,72063,-391,0.064
2010-02-16,608338,75616,54106,21510,3.536
2010-02-23,547226,73489,45995,27494,5.024
2010-03-02,530429,72365,45275,27090,5.107
2010-03-09,542939,71764,59938,11826,2.178
2010-03-16,553028,72588,62748,9840,1.779
2010-03-23,553525,77446,36741,40705,7.354
2010-03-30,574632,77268,32789,44479,7.74
2010-04-06,578148,69511,50547,18964,3.28
2010-04-13,595069,83380,38800,44580,7.492
2010-04-20,625129,97675,25380,72295,11.565
2010-04-27,609276,106051,21106,84945,13.942
2010-05-04,600207,106041,28868,77173,12.858
2010-05-11,590442,83673,40333,43340,7.34
2010-05-18,603692,68484,52431,16053,2.659
2010-05-25,592187,58512,54900,3612,0.61
2010-06-01,602378,55327,56504,-1177,0.195
2010-06-08,619680,54072,62209,-8137,1.313
2010-06-15,600485,62935,49943,12992,2.164
2010-06-22,601266,72883,44265,28618,4.76
2010-06-29,550065,64574,47925,16649,3.027
2010-07-06,560358,61567,63224,-1657,0.296
2010-07-13,596150,86332,30380,55952,9.386
2010-07-20,617391,113871,17509,96362,15.608
2010-07-27,584787,110127,17218,92909,15.888
2010-08-03,620755,128456,12431,116025,18.691
2010-08-10,653055,140854,9331,131523,20.14
2010-08-17,676855,146208,8564,137644,20.336
2010-08-24,672089,136334,6422,129912,19.33
2010-08-31,659521,133408,6949,126459,19.174
2010-09-07,686457,143467,6851,136616,19.902
2010-09-14,691008,143399,6420,136979,19.823
2010-09-21,754876,157615,7762,149853,19.851
2010-09-28,812023,169458,9664,159794,19.679
2010-10-05,802303,149751,11231,138520,17.265
2010-10-12,882934,151251,5126,146125,16.55
2010-10-19,904359,168038,4019,164019,18.136
2010-10-26,824864,165162,4116,161046,19.524
2010-11-02,809479,173111,2817,170294,21.037
2010-11-09,878931,183964,4211,179753,20.451
2010-11-16,883783,157494,5540,151954,17.194
2010-11-23,912974,153703,5637,148066,16.218
2010-11-30,907072,147614,6571,141043,15.549
2010-12-07,935192,150000,6256,143744,15.371
2010-12-14,955765,154272,5168,149104,15.6
2010-12-21,984720,164479,5624,158855,16.132
2010-12-28,927497,168892,4605,164287,17.713
2011-01-04,910214,158151,4019,154132,16.934
2011-01-11,909097,156391,3532,152859,16.814
2011-01-18,965579,163777,2822,160955,16.669
2011-01-25,935166,150104,7088,143016,15.293
2011-02-01,985063,173228,4243,168985,17.155
2011-02-08,1009315,167697,3428,164269,16.275
2011-02-15,1003821,149224,14958,134266,13.375
2011-02-22,863916,126446,15434,111012,12.85
2011-03-01,851201,127378,12135,115243,13.539
2011-03-08,867118,132254,5427,126827,14.626
2011-03-15,898859,112371,18171,94200,10.48
2011-03-22,896050,125747,10908,114839,12.816
2011-03-29,882782,124899,9913,114986,13.025
2011-04-05,898833,135299,17019,118280,13.159
2011-04-12,919879,122004,23634,98370,10.694
2011-04-19,912002,114691,26800,87891,9.637
2011-04-26,818174,125554,15196,110358,13.488
2011-05-03,798347,118675,15780,102895,12.889
2011-05-10,783601,106345,15971,90374,11.533
2011-05-17,774141,104373,18952,85421,11.034
2011-05-24,788602,119363,19106,100257,12.713
2011-05-31,816397,126500,21226,105274,12.895
2011-06-07,846307,140379,22828,117551,13.89
2011-06-14,835443,126684,27005,99679,11.931
2011-06-21,825892,109287,30223,79064,9.573
2011-06-28,712724,95196,34036,61160,8.581
2011-07-05,701227,94343,37112,57231,8.162
2011-07-12,701473,106172,26247,79925,11.394
2011-07-19,756471,137615,18491,119124,15.747
2011-07-26,726297,144323,19232,125091,17.223
2011-08-02,709119,133592,22166,111426,15.713
2011-08-09,707033,95334,31146,64188,9.079
2011-08-16,708542,105473,25362,80111,11.306
2011-08-23,751738,143974,12323,131651,17.513
2011-08-30,819218,186082,7520,178562,21.797
2011-09-06,832778,182113,8022,174091,20.905
2011-09-13,836554,170065,11384,158681,18.968
2011-09-20,812514,128076,12285,115791,14.251
2011-09-27,823913,96049,26839,69210,8.4
2011-10-04,889103,79937,29815,50122,5.637
2011-10-11,870469,76922,36092,40830,4.691
2011-10-18,877888,91560,37172,54388,6.195
2011-10-25,696883,85813,38807,47006,6.745
2011-11-01,680576,80085,44378,35707,5.247
2011-11-08,681033,75584,47312,28272,4.151
2011-11-15,702174,73589,63456,10133,1.443
2011-11-22,721811,61883,70505,-8622,1.194
2011-11-29,720395,62623,70070,-7447,1.034
2011-12-06,741404,60373,70566,-10193,1.375
2011-12-13,767702,63961,67119,-3158,0.411
2011-12-20,739312,61493,58918,2575,0.348
2011-12-27,639929,71654,47971,23683,3.701
2012-01-03,635183,79038,46018,33020,5.199
2012-01-10,659748,83927,39310,44617,6.763
2012-01-17,671915,77671,44123,33548,4.993
2012-01-24,684919,87218,41834,45384,6.626
2012-01-31,684586,88831,48213,40618,5.933
2012-02-07,710111,103312,40456,62856,8.852
2012-02-14,756274,113051,32009,81042,10.716
2012-02-21,763912,125310,28339,96971,12.694
2012-02-28,737025,141781,24103,117678,15.967
2012-03-06,789533,171396,15030,156366,19.805
2012-03-13,846793,189452,13361,176091,20.795
2012-03-20,904276,213407,12193,201214,22.251
2012-03-27,939213,216903,6901,210002,22.359
2012-04-03,1048315,240539,5152,235387,22.454
2012-04-10,1095714,250113,7440,242673,22.147
2012-04-17,1137348,247306,6532,240774,21.17
2012-04-24,1077314,249694,6305,243389,22.592
2012-05-01,1112165,261045,7156,253889,22.828
2012-05-08,1100686,238303,7975,230328,20.926
2012-05-15,1104590,223123,5035,218088,19.744
2012-05-22,1108738,214768,12461,202307,18.247
2012-05-29,1093933,215036,13201,201835,18.45
2012-06-05,1082409,193971,15000,178971,16.535
2012-06-12,1099528,218940,5984,212956,19.368
2012-06-19,1116839,220530,2976,217554,19.479
2012-06-26,1046687,238075,5486,232589,22.221
2012-07-03,1105822,254068,3986,250082,22.615
2012-07-10,1177621,255198,4406,250792,21.296
2012-07-17,1257622,257135,4196,252939,20.112
2012-07-24,1259806,245183,4317,240866,19.119
2012-07-31,1165730,244831,3743,241088,20.681
2012-08-07,1140078,231430,6696,224734,19.712
2012-08-14,1140549,234206,3661,230545,20.214
2012-08-21,1231055,254521,2133,252388,20.502
2012-08-28,1156476,238936,6396,232540,20.108
2012-09-04,1197773,242051,4380,237671,19.843
2012-09-11,1168390,231944,3125,228819,19.584
2012-09-18,1157098,216759,6884,209875,18.138
2012-09-25,1136216,198586,3184,195402,17.198
2012-10-02,1125249,186407,7665,178742,15.885
2012-10-09,1131066,184000,7093,176907,15.641
2012-10-16,1126262,173818,6722,167096,14.836
2012-10-23,1103335,180099,7751,172348,15.621
2012-10-30,841602,180385,6191,174194,20.698
2012-11-06,837306,174606,10078,164528,19.65
2012-11-13,860728,148559,22710,125849,14.621
2012-11-20,874049,139257,26467,112790,12.904
2012-11-27,843320,138272,29711,108561,12.873
2012-12-04,849291,135421,28759,106662,12.559
2012-12-11,858490,144392,21117,123275,14.36
2012-12-18,875152,153077,23088,129989,14.853
2012-12-24,772684,135727,26720,109007,14.108
2012-12-31,756932,132928,30978,101950,13.469
2013-01-08,760316,118923,45671,73252,9.634
2013-01-15,761604,118882,39446,79436,10.43
2013-01-22,787074,125502,27708,97794,12.425
2013-01-29,807210,131652,26635,105017,13.01
2013-02-05,890329,158688,23044,135644,15.235
2013-02-12,882769,159386,25653,133733,15.149
2013-02-19,906979,154687,28169,126518,13.949
2013-02-26,797229,145649,22651,122998,15.428
2013-03-05,813389,147961,19665,128296,15.773
2013-03-12,827046,156651,17307,139344,16.848
2013-03-19,807250,130081,30157,99924,12.378
2013-03-26,795077,134931,22579,112352,14.131
2013-04-02,780729,116646,39431,77215,9.89
2013-04-09,801665,114115,51515,62600,7.809
2013-04-16,789066,120328,45759,74569,9.45
2013-04-23,810498,117443,43738,73705,9.094
2013-04-30,730966,131125,39815,91310,12.492
2013-05-07,735671,125391,52327,73064,9.932
2013-05-14,782164,139321,55495,83826,10.717
2013-05-21,829734,164999,59740,105259,12.686
2013-05-28,845705,185790,59066,126724,14.984
2013-06-04,894137,189690,48513,141177,15.789
2013-06-11,918497,200075,46640,153435,16.705
2013-06-18,920174,186409,52121,134288,14.594
2013-06-25,770698,171710,43430,128280,16.645
2013-07-02,742553,155186,44374,110812,14.923
2013-07-09,741375,150578,38390,112188,15.132
2013-07-16,752912,169209,44777,124432,16.527
2013-07-23,770598,168461,58819,109642,14.228
2013-07-30,729592,136707,61217,75490,10.347
2013-08-06,757161,119267,75687,43580,5.756
2013-08-13,759301,120681,73504,47177,6.213
2013-08-20,800696,148278,48290,99988,12.488
2013-08-27,829919,165826,27644,138182,16.65
2013-09-03,877640,181962,22524,159438,18.167
2013-09-10,889565,172225,26292,145933,16.405
2013-09-17,890031,174202,26451,147751,16.601
2013-09-24,870333,160835,25583,135252,15.54
2013-10-01,882590,138504,28644,109860,12.447
2013-10-08,871614,137768,28502,109266,12.536
2013-10-15,890058,139515,27336,112179,12.604
2013-10-22,882349,146309,27014,119295,13.52
2013-10-29,709780,141995,25637,116358,16.394
2013-11-05,700143,138280,40715,97565,13.935
2013-11-12,711578,149229,28338,120891,16.989
2013-11-19,723098,157313,27920,129393,17.894
2013-11-26,741684,172118,25950,146168,19.708
2013-12-03,756122,181594,30516,151078,19.981
2013-12-10,789314,190150,27245,162905,20.639
2013-12-17,811261,198092,25736,172356,21.245
2013-12-24,786037,193993,28270,165723,21.083
2013-12-31,712941,178337,41654,136683,19.172
2014-01-07,722037,155523,47865,107658,14.91
2014-01-14,739472,168011,41640,126371,17.089
2014-01-21,764688,172729,45568,127161,16.629
2014-01-28,743080,162874,41243,121631,16.368
2014-02-04,778519,177296,30763,146533,18.822
2014-02-11,835846,201715,25589,176126,21.072
2014-02-18,858410,217062,21570,195492,22.774
2014-02-25,834272,220101,17105,202996,24.332
2014-03-04,831220,227781,19288,208493,25.083
2014-03-11,849739,221980,23360,198620,23.374
2014-03-18,842042,220695,22023,198672,23.594
2014-03-25,795823,206871,21442,185429,23.3
2014-04-01,833669,212707,19261,193446,23.204
2014-04-08,848303,206487,25235,181252,21.366
2014-04-15,901130,210283,23746,186537,20.7
2014-04-22,903409,194823,29672,165151,18.281
2014-04-29,788198,195362,26486,168876,21.426
2014-05-06,760332,173398,35354,138044,18.156
2014-05-13,781803,171829,40066,131763,16.854
2014-05-20,798278,167027,46108,120919,15.147
2014-05-27,816108,167348,40311,127037,15.566
2014-06-03,835276,160511,56361,104150,12.469
2014-06-10,842051,150631,70488,80143,9.518
2014-06-17,852366,139107,92483,46624,5.47
2014-06-24,764084,135322,94101,41221,5.395
2014-07-01,807301,134422,112218,22204,2.75
2014-07-08,861151,125886,123744,2142,0.249
2014-07-15,918357,117095,123184,-6089,0.663
2014-07-22,990767,113260,131803,-18543,1.872
2014-07-29,895718,113943,122262,-8319,0.929
2014-08-05,956311,114374,128987,-14613,1.528
2014-08-12,976948,111084,122788,-11704,1.198
2014-08-19,975664,110322,127020,-16698,1.711
2014-08-26,956762,109532,131472,-21940,2.293
2014-09-02,982562,110247,135821,-25574,2.603
2014-09-09,1062781,101779,141565,-39786,3.744
2014-09-16,1119449,101898,135627,-33729,3.013
2014-09-23,1213730,102259,125950,-23691,1.952
2014-09-30,1240345,104006,119220,-15214,1.227
2014-10-07,1232537,98334,122791,-24457,1.984
2014-10-14,1258886,99126,116316,-17190,1.365
2014-10-21,1239334,97190,113527,-16337,1.318
2014-10-28,901622,103505,95123,8382,0.93
2014-11-04,893426,107139,88442,18697,2.093
2014-11-11,899654,116504,75151,41353,4.597
2014-11-18,916099,107971,77238,30733,3.355
2014-11-25,892505,112295,74476,37819,4.237
2014-12-02,915637,99530,84635,14895,1.627
2014-12-09,929951,107843,64199,43644,4.693
2014-12-16,948096,110746,74492,36254,3.824
2014-12-23,903785,113534,74826,38708,4.283
2014-12-30,787117,117324,77878,39446,5.011
2015-01-06,803171,118956,76353,42603,5.304
2015-01-13,842371,109063,94543,14520,1.724
2015-01-20,908821,96901,104440,-7539,0.83
2015-01-27,925371,82406,115427,-33021,3.568
2015-02-03,958275,90577,105929,-15352,1.602
2015-02-10,995015,81087,120744,-39657,3.986
2015-02-17,950537,89454,105113,-15659,1.647
2015-02-24,884614,97967,97683,284,0.032
2015-03-03,896551,94899,91122,3777,0.421
2015-03-10,913568,79962,97376,-17414,1.906
2015-03-17,990121,73100,112786,-39686,4.008
2015-03-24,982456,75675,114517,-38842,3.954
2015-03-31,996400,78212,124413,-46201,4.637
2015-04-07,985276,73349,121941,-48592,4.932
2015-04-14,1050407,64333,146049,-81716,7.779
2015-04-21,1000232,71660,119165,-47505,4.749
2015-04-28,881492,80004,112037,-32033,3.634
2015-05-05,888556,84083,113263,-29180,3.284
2015-05-12,909506,83095,133546,-50451,5.547
2015-05-19,922573,67818,158089,-90271,9.785
2015-05-26,946375,66959,170922,-103963,10.985
2015-06-02,983354,70366,165147,-94781,9.639
2015-06-09,991973,71204,154144,-82940,8.361
2015-06-16,993940,83477,147025,-63548,6.394
2015-06-23,964765,92393,90564,1829,0.19
2015-06-30,913737,115514,47918,67596,7.398
2015-07-07,897572,118062,44806,73256,8.162
2015-07-14,925347,118361,33257,85104,9.197
2015-07-21,916868,120150,29931,90219,9.84
2015-07-28,834652,106108,43813,62295,7.464
2015-08-04,850424,99462,48596,50866,5.981
2015-08-11,859110,100836,41483,59353,6.909
2015-08-18,899748,87527,67843,19684,2.188
2015-08-25,887819,69937,69162,775,0.087
2015-09-01,896140,66600,83902,-17302,1.931
2015-09-08,897429,68636,87152,-18516,2.063
2015-09-15,911018,69897,94919,-25022,2.747
2015-09-22,959284,67952,114202,-46250,4.821
2015-09-29,944877,65877,96374,-30497,3.228
2015-10-06,950613,69132,88288,-19156,2.015
2015-10-13,981222,84214,82107,2107,0.215
2015-10-20,978958,75669,72809,2860,0.292
2015-10-27,788010,76618,74242,2376,0.302
2015-11-03,777481,66644,87120,-20476,2.634
2015-11-10,824618,64716,117017,-52301,6.342
2015-11-17,843583,60028,110913,-50885,6.032
2015-11-24,856763,54851,107776,-52925,6.177
2015-12-01,857662,65558,100326,-34768,4.054
2015-12-08,875282,75888,87003,-11115,1.27
2015-12-15,878010,66924,96443,-29519,3.362
2015-12-22,864240,61148,92829,-31681,3.666
2015-12-29,799448,52596,116111,-63515,7.945
2016-01-05,823470,55857,135404,-79547,9.66
2016-01-12,837091,66840,119880,-53040,6.336
2016-01-19,833868,70022,95795,-25773,3.091
2016-01-26,846887,68542,98998,-30456,3.596
2016-02-02,889581,80711,106573,-25862,2.907
2016-02-09,921162,64866,133003,-68137,7.397
2016-02-16,922451,79088,122479,-43391,4.704
2016-02-23,861814,85342,107401,-22059,2.56
2016-03-01,866539,59714,141172,-81458,9.4
2016-03-08,876425,68028,110934,-42906,4.896
2016-03-15,906462,102940,81166,21774,2.402
2016-03-22,981010,123531,69849,53682,5.472
2016-03-29,978426,139838,64388,75450,7.711
2016-04-05,977839,141131,67390,73741,7.541
2016-04-12,1082919,158911,58695,100216,9.254
2016-04-19,1214912,177043,41633,135410,11.146
2016-04-26,1078368,190823,30698,160125,14.849
2016-05-03,1099929,202123,34569,167554,15.233
2016-05-10,1201469,226350,24568,201782,16.795
2016-05-17,1231919,217541,12388,205153,16.653
2016-05-24,1185742,210821,8648,202173,17.05
2016-05-31,1216683,219658,10962,208696,17.153
2016-06-07,1253890,219250,9199,210051,16.752
2016-06-14,1302943,214563,7475,207088,15.894
2016-06-21,1282136,205909,5120,200789,15.661
2016-06-28,1100046,199285,4015,195270,17.751
2016-07-05,1072802,181189,13861,167328,15.597
2016-07-12,1119086,170400,10993,159407,14.244
2016-07-19,1118941,152869,15177,137692,12.306
2016-07-26,969840,137512,15823,121689,12.547
2016-08-02,957855,126611,20273,106338,11.102
2016-08-09,948122,129076,16081,112995,11.918
2016-08-16,933946,121874,19974,101900,10.911
2016-08-23,932722,145242,17944,127298,13.648
2016-08-30,853978,119291,19658,99633,11.667
2016-09-06,850942,106997,23310,83687,9.835
2016-09-13,858674,104062,25073,78989,9.199
2016-09-20,876710,112363,21930,90433,10.315
2016-09-27,867089,96503,38851,57652,6.649
2016-10-04,876633,102331,37164,65167,7.434
2016-10-11,879235,99028,25959,73069,8.311
2016-10-18,899743,110131,22480,87651,9.742
2016-10-25,725091,118416,19811,98605,13.599
2016-11-01,717637,132247,21634,110613,15.414
2016-11-08,729804,141795,17531,124264,17.027
2016-11-15,735285,126770,28593,98177,13.352
2016-11-22,797175,146043,32399,113644,14.256
2016-11-29,841404,169730,35025,134705,16.01
2016-12-06,866834,159456,36808,122648,14.149
2016-12-13,880522,157325,36575,120750,13.713
2016-12-20,860636,149766,38054,111712,12.98
2016-12-27,783863,136707,29632,107075,13.66
2017-01-03,753646,129474,35227,94247,12.505
2017-01-10,753124,131559,35669,95890,12.732
2017-01-17,832348,161500,29978,131522,15.801
2017-01-24,888526,204613,28203,176410,19.854
2017-01-31,880384,186474,33622,152852,17.362
2017-02-07,894710,176694,26380,150314,16.8
2017-02-14,939543,193126,22458,170668,18.165
2017-02-21,937737,182681,28374,154307,16.455
2017-02-28,828977,167059,35483,131576,15.872
2017-03-07,832019,166104,38466,127638,15.341
2017-03-14,851069,144284,45930,98354,11.557
2017-03-21,882245,126097,60428,65669,7.443
2017-03-28,900849,116337,78407,37930,4.21
2017-04-04,972367,94828,94106,722,0.074
2017-04-11,1005527,86102,115835,-29733,2.957
2017-04-18,1006985,87811,133639,-45828,4.551
2017-04-25,821873,85259,133534,-48275,5.874
2017-05-02,796675,87102,134769,-47667,5.983
2017-05-09,799068,97802,132137,-34335,4.297
2017-05-16,804104,96448,132971,-36523,4.542
2017-05-23,843018,82366,144721,-62355,7.397
2017-05-30,881728,74722,164032,-89310,10.129
2017-06-06,904932,82054,176791,-94737,10.469
2017-06-13,903351,83694,163367,-79673,8.82
2017-06-20,916537,79115,166255,-87140,9.508
2017-06-27,839666,73971,192654,-118683,14.135
2017-07-03,847190,90166,160382,-70216,8.288
2017-07-11,908861,107120,88072,19048,2.096
2017-07-18,860651,108942,70591,38351,4.456
2017-07-25,793968,108103,57218,50885,6.409
2017-08-01,793582,101870,62075,39795,5.015
2017-08-08,796479,83318,70405,12913,1.621
2017-08-15,858554,76451,90850,-14399,1.677
2017-08-22,877727,79296,102690,-23394,2.665
2017-08-29,798548,78404,106771,-28367,3.552
2017-09-05,816962,84903,96847,-11944,1.462
2017-09-12,827274,88483,92891,-4408,0.533
2017-09-19,821337,90653,76906,13747,1.674
2017-09-26,819398,98199,69879,28320,3.456
2017-10-03,848692,99872,72114,27758,3.271
2017-10-10,877789,91567,60575,30992,3.531
2017-10-17,907268,109796,41628,68168,7.514
2017-10-24,930344,99737,50491,49246,5.293
2017-10-31,758371,96003,55391,40612,5.355
2017-11-07,801232,100225,53487,46738,5.833
2017-11-14,824750,95309,72759,22550,2.734
2017-11-21,833552,85919,65775,20144,2.417
2017-11-28,832314,88683,57021,31662,3.804
2017-12-05,889756,104639,51505,53134,5.972
2017-12-12,846620,87079,67324,19755,2.333
2017-12-19,893209,71988,112759,-40771,4.565
2017-12-26,841222,70423,139514,-69091,8.213
2018-01-02,814798,67812,153318,-85506,10.494
2018-01-09,843057,69212,162047,-92835,11.012
2018-01-16,886347,70025,173422,-103397,11.666
2018-01-23,914648,73190,154728,-81538,8.915
2018-01-30,929890,82911,104760,-21849,2.35
2018-02-06,927214,81826,91804,-9978,1.076
2018-02-13,929483,96776,53907,42869,4.612
2018-02-20,1004294,124578,25467,99111,9.869
2018-02-27,931437,162010,14630,147380,15.823
2018-03-06,1010410,195113,11402,183711,18.182
2018-03-13,1042930,216530,8330,208200,19.963
2018-03-20,1045359,204617,9095,195522,18.704
2018-03-27,1057007,192562,8984,183578,17.368
2018-04-03,1101433,193092,11938,181154,16.447
2018-04-10,1153636,188091,11874,176217,15.275
2018-04-17,1174860,200689,7721,192968,16.425
2018-04-24,1055909,181960,11866,170094,16.109
2018-05-01,1020055,188497,11450,177047,17.357
2018-05-08,1034304,152166,25124,127042,12.283
2018-05-15,1069154,145868,37807,108061,10.107
2018-05-22,1094121,131972,33744,98228,8.978
2018-05-29,1096288,137525,30427,107098,9.769
2018-06-05,1105632,115266,42967,72299,6.539
2018-06-12,1158517,92278,79408,12870,1.111
2018-06-19,1199773,92652,105453,-12801,1.067
2018-06-26,1020620,82439,126424,-43985,4.31
2018-07-03,1006046,77026,130703,-53677,5.335
2018-07-10,1039967,80991,134238,-53247,5.12
2018-07-17,1091032,81668,140067,-58399,5.353
2018-07-24,1090029,88113,149428,-61315,5.625
2018-07-31,1000785,91666,150337,-58671,5.862
2018-08-07,989374,83942,140225,-56283,5.689
2018-08-14,995560,81066,139990,-58924,5.919
2018-08-21,991658,82636,122685,-40049,4.039
2018-08-28,984531,79288,132930,-53642,5.448
2018-09-04,986647,81450,144199,-62749,6.36
2018-09-11,1016904,81527,149796,-68269,6.713
2018-09-18,1071417,87129,156942,-69813,6.516
2018-09-25,1033689,91183,149797,-58614,5.67
2018-10-02,1036462,92624,137027,-44403,4.284
2018-10-09,1023172,88778,130179,-41401,4.046
2018-10-16,1038852,84889,121257,-36368,3.501
2018-10-23,1007499,84626,129048,-44422,4.409
2018-10-30,857128,75156,146461,-71305,8.319
2018-11-06,863966,74440,119518,-45078,5.218
2018-11-13,862245,73174,128199,-55025,6.382
2018-11-20,858578,72106,132352,-60246,7.017
2018-11-27,863843,75373,139235,-63862,7.393
2018-12-04,887846,87718,105311,-17593,1.982
2018-12-11,883438,81852,92920,-11068,1.253
2018-12-18,876677,81661,81311,350,0.04
2018-12-24,801293,75725,86270,-10545,1.316
2018-12-31,767589,70449,88585,-18136,2.363
2019-01-08,779971,79049,80269,-1220,0.156
2019-01-15,802437,70020,90902,-20882,2.602
2019-01-22,821410,65557,88471,-22914,2.79
2019-01-29,811858,76101,77298,-1197,0.147
2019-02-05,862754,82134,76145,5989,0.694
2019-02-12,861492,76018,86056,-10038,1.165
2019-02-19,861682,68255,111065,-42810,4.968
2019-02-26,749083,72672,108654,-35982,4.803
2019-03-05,763800,71483,121785,-50302,6.586
2019-03-12,817173,66865,157062,-90197,11.038
2019-03-19,814860,74030,138022,-63992,7.853
2019-03-26,829090,82154,133548,-51394,6.199
2019-04-02,862409,81154,155323,-74169,8.6
2019-04-09,900302,77891,149205,-71314,7.921
2019-04-16,934191,74442,165842,-91400,9.784
2019-04-23,990947,63165,192731,-129566,13.075
2019-04-30,879342,58743,207269,-148526,16.891
2019-05-07,936496,59900,220453,-160553,17.144
2019-05-14,962057,58501,227336,-168835,17.549
2019-05-21,994965,61915,215046,-153131,15.391
2019-05-28,961941,63687,193681,-129994,13.514
2019-06-04,960273,65318,158674,-93356,9.722
2019-06-11,950678,67943,159098,-91155,9.588
2019-06-18,996601,72020,127327,-55307,5.55
2019-06-25,788536,67891,101933,-34042,4.317
2019-07-02,784366,65386,102336,-36950,4.711
2019-07-09,812433,69740,111674,-41934,5.162
2019-07-16,811228,70695,109630,-38935,4.8
2019-07-23,817103,73563,112052,-38489,4.71
2019-07-30,729129,73513,127085,-53572,7.347
2019-08-06,770883,72234,145047,-72813,9.445
2019-08-13,751743,73004,139454,-66450,8.839
2019-08-20,776580,75480,147912,-72432,9.327
2019-08-27,748556,74864,150911,-76047,10.159
2019-09-03,749565,76266,149393,-73127,9.756
2019-09-10,781241,67953,159690,-91737,11.742
2019-09-17,793509,76605,124786,-48181,6.072
2019-09-24,805480,77298,118986,-41688,5.176
2019-10-01,850859,90614,99344,-8730,1.026
2019-10-08,858088,101103,94602,6501,0.758
2019-10-15,918041,117605,68576,49029,5.341
2019-10-22,961653,126396,57574,68822,7.157
2019-10-29,819092,126368,54043,72325,8.83
2019-11-05,814903,120336,61907,58429,7.17
2019-11-12,856390,104333,73283,31050,3.626
2019-11-19,883341,96018,77566,18452,2.089
2019-11-26,930712,73378,116319,-42941,4.614
2019-12-03,987980,62499,161518,-99019,10.022
2019-12-10,1005156,61735,174263,-112528,11.195
2019-12-17,969569,71537,150812,-79275,8.176
2019-12-24,931796,74583,107739,-33156,3.558
2019-12-31,848230,80253,83412,-3159,0.372
2020-01-07,859039,80407,79248,1159,0.135
2020-01-14,887409,81879,75589,6290,0.709
2020-01-21,914140,70983,84718,-13735,1.503
2020-01-28,955012,68634,119589,-50955,5.336
2020-02-04,1020423,72923,155281,-82358,8.071
2020-02-11,1048773,75153,167325,-92172,8.789
2020-02-18,1026078,74246,164009,-89763,8.748
2020-02-25,932765,84273,159403,-75130,8.055
2020-03-03,920924,85024,120792,-35768,3.884
2020-03-10,956756,79527,106001,-26474,2.767
2020-03-17,985804,64051,94697,-30646,3.109
2020-03-24,960687,63159,65603,-2444,0.254
2020-03-31,958222,71741,48511,23230,2.424
2020-04-07,1003031,70110,52949,17161,1.711
2020-04-14,1029023,72108,59586,12522,1.217
2020-04-21,1059115,72457,75321,-2864,0.27
2020-04-28,975705,73757,69365,4392,0.45
2020-05-05,973256,78679,69771,8908,0.915
2020-05-12,1025674,93808,61343,32465,3.165
2020-05-19,1038765,87500,75436,12064,1.161
2020-05-26,1042699,85973,80160,5813,0.557
2020-06-02,1047660,86218,79581,6637,0.634
2020-06-09,1044618,90079,69703,20376,1.951
2020-06-16,1063884,88795,67612,21183,1.991
2020-06-23,1045355,97184,52899,44285,4.236
2020-06-30,949644,115799,47963,67836,7.143
2020-07-07,1001034,129946,30703,99243,9.914
2020-07-14,975293,104580,38605,65975,6.765
2020-07-21,994119,115438,39629,75809,7.626
2020-07-28,967977,112686,50525,62161,6.422
2020-08-04,975735,98200,53981,44219,4.532
2020-08-11,984159,87283,60419,26864,2.73
2020-08-18,983437,133451,26393,107058,10.886
2020-08-25,965554,137781,28493,109288,11.319
2020-09-01,1033542,183228,20621,162607,15.733
2020-09-08,1069089,192307,18400,173907,16.267
2020-09-15,1147625,207898,16124,191774,16.711
2020-09-22,1218442,221987,10844,211143,17.329
2020-09-29,1190425,238282,9239,229043,19.24
2020-10-06,1273728,243910,5516,238394,18.716
2020-10-13,1317802,236129,9685,226444,17.183
2020-10-20,1326365,235401,3509,231892,17.483
2020-10-27,1167917,236805,4088,232717,19.926
2020-11-03,1126533,217301,6344,210957,18.726
2020-11-10,1212671,224018,2924,221094,18.232
2020-11-17,1249960,215946,7172,208774,16.702
2020-11-24,1262347,213263,9453,203810,16.145
2020-12-01,1253881,207051,12368,194683,15.526
2020-12-08,1254808,199967,14312,185655,14.795
2020-12-15,1278091,199512,9294,190218,14.883
2020-12-21,1346329,203220,14597,188623,14.01
2020-12-29,1217723,210207,13720,196487,16.136
2021-01-05,1282647,190171,14344,175827,13.708
2021-01-12,1342333,183948,17463,166485,12.403
2021-01-19,1355785,169591,17693,151898,11.204
2021-01-26,1315695,170979,14389,156590,11.902
2021-02-02,1311283,170379,14114,156265,11.917
2021-02-09,1321924,182771,11001,171770,12.994
2021-02-16,1294632,171864,10454,161410,12.468
2021-02-23,1173245,182231,9867,172364,14.691
2021-03-02,1156624,166750,11189,155561,13.45
2021-03-09,1193643,171853,12252,159601,13.371
2021-03-16,1179511,169014,12974,156040,13.229
2021-03-23,1176773,174370,11517,162853,13.839
2021-03-30,1175658,159746,17866,141880,12.068
2021-04-06,1193107,167371,13066,154305,12.933
2021-04-13,1208328,159295,17037,142258,11.773
2021-04-20,1249501,185169,12625,172544,13.809
2021-04-27,1167102,191598,11584,180014,15.424
2021-05-04,1139988,186360,11561,174799,15.333
2021-05-11,1173327,188101,10279,177822,15.155
2021-05-18,1175415,163408,10824,152584,12.981
2021-05-25,1142076,149979,10589,139390,12.205
2021-06-01,1165736,149255,10467,138788,11.906
2021-06-08,1195861,152377,10894,141483,11.831
2021-06-15,1165967,121079,13587,107492,9.219
2021-06-22,1145008,93976,13672,80304,7.013
2021-06-29,926661,94060,17803,76257,8.229
2021-07-06,945291,101396,19216,82180,8.694
2021-07-13,937499,96842,14069,82773,8.829
2021-07-20,959460,107771,11897,95874,9.992
2021-07-27,885088,104263,10212,94051,10.626
2021-08-03,867297,95839,17553,78286,9.026
2021-08-10,873847,103364,11716,91648,10.488
2021-08-17,878154,108431,11252,97179,11.066
2021-08-24,899684,101854,18629,83225,9.25
2021-08-31,853399,94373,25232,69141,8.102
2021-09-07,852228,88451,30935,57516,6.749
2021-09-14,845260,83457,28077,55380,6.552
2021-09-21,857135,78945,29244,49701,5.799
2021-09-28,871342,84503,25192,59311,6.807
2021-10-05,908200,82105,32652,49453,5.445
2021-10-12,978147,75299,46231,29068,2.972
2021-10-19,963784,76864,58699,18165,1.885
2021-10-26,762618,78898,54987,23911,3.135
2021-11-02,728618,90488,47807,42681,5.858
2021-11-09,765567,80462,68325,12137,1.585
2021-11-16,785185,86142,56654,29488,3.756
2021-11-23,823369,93597,44241,49356,5.994
2021-11-30,790880,84257,50832,33425,4.226
2021-12-07,791580,80790,42908,37882,4.786
2021-12-14,767185,78536,37561,40975,5.341
2021-12-21,789405,100318,27394,72924,9.238
2021-12-28,767439,117661,19581,98080,12.78
2022-01-04,789340,118166,19247,98919,12.532
2022-01-11,833968,126233,19354,106879,12.816
2022-01-18,841473,127689,28050,99639,11.841
2022-01-25,883842,137708,22813,114895,12.999
2022-02-01,1006519,167530,13042,154488,15.349
2022-02-08,1078690,177539,11224,166315,15.418
2022-02-15,1124836,185807,10435,175372,15.591
2022-02-22,1036939,190908,10574,180334,17.391
2022-03-01,1007315,184742,9021,175721,17.444
2022-03-08,1003054,177561,5847,171714,17.119
2022-03-15,999098,176729,6039,170690,17.084
2022-03-22,1016326,180140,5948,174192,17.139
2022-03-29,982306,164777,8504,156273,15.909
2022-04-05,979037,170135,6480,163655,16.716
2022-04-12,984410,178210,6337,171873,17.459
2022-04-19,1005019,183980,4257,179723,17.883
2022-04-26,904744,177794,4317,173477,19.174
2022-05-03,888673,164290,11037,153253,17.245
2022-05-10,895823,147662,17001,130661,14.586
2022-05-17,920248,163464,16129,147335,16.01
2022-05-24,932993,176620,13553,163067,17.478
2022-05-31,963118,178733,14103,164630,17.093
2022-06-07,979103,173416,14488,158928,16.232
2022-06-14,971426,174546,11400,163146,16.794
2022-06-21,959863,169189,14776,154413,16.087
2022-06-28,800466,142757,18259,124498,15.553
2022-07-05,805841,131143,26095,105048,13.036
2022-07-12,790441,113616,17905,95711,12.109
2022-07-19,782719,103828,15996,87832,11.221
2022-07-26,724199,105592,17916,87676,12.107
2022-08-02,733897,111470,11999,99471,13.554
2022-08-09,749412,113032,11523,101509,13.545
2022-08-16,756272,112960,13624,99336,13.135
2022-08-23,789452,120146,15675,104471,13.233
2022-08-30,741434,120583,18782,101801,13.73
2022-09-06,741820,115876,16247,99629,13.43
2022-09-13,794029,127001,14874,112127,14.121
2022-09-20,808861,122496,17805,104691,12.943
2022-09-27,830261,110282,15451,94831,11.422
2022-10-04,810388,94762,17274,77488,9.562
2022-10-11,833186,86799,21061,65738,7.89
2022-10-18,847777,87049,20187,66862,7.887
2022-10-25,721646,94055,18644,75411,10.45
2022-11-01,669123,115356,14027,101329,15.144
2022-11-08,703484,115198,11290,103908,14.77
2022-11-15,711647,108966,16001,92965,13.063
2022-11-22,718082,104289,22154,82135,11.438
2022-11-29,721613,120171,18067,102104,14.149
2022-12-06,719341,128251,28797,99454,13.826
2022-12-13,744707,142217,22637,119580,16.057
2022-12-20,733115,146007,22438,123569,16.855
2022-12-27,682246,151222,22606,128616,18.852
2023-01-03,703996,166894,23900,142994,20.312
2023-01-10,727769,157767,26063,131704,18.097
2023-01-17,771901,186794,18496,168298,21.803
2023-01-24,797356,172806,26545,146261,18.343
2023-01-31,807030,193385,17881,175504,21.747
2023-02-07,840111,187873,22798,165075,19.649
2023-02-14,868514,198299,16091,182208,20.979
2023-02-21,860772,202144,13135,189009,21.958
2023-02-28,789610,158970,29360,129610,16.414
2023-03-07,816692,176449,19119,157330,19.264
2023-03-14,840290,147580,19919,127661,15.192
2023-03-21,867790,134522,23736,110786,12.766
2023-03-28,886818,127121,27599,99522,11.222
2023-04-04,911421,158354,12390,145964,16.015
2023-04-11,882745,142652,17630,125022,14.163
2023-04-18,856008,153973,19191,134782,15.745
2023-04-25,750013,115327,28119,87208,11.628
2023-05-02,733018,107640,51267,56373,7.691
2023-05-09,762666,106385,57926,48459,6.354
2023-05-16,815277,98465,74523,23942,2.937
2023-05-23,842442,84208,80061,4147,0.492
2023-05-30,847867,76883,76354,529,0.062
2023-06-06,854072,81729,67748,13981,1.637
2023-06-13,845019,98056,50174,47882,5.666
2023-06-20,875106,112152,35202,76950,8.793
2023-06-27,766683,129506,30026,99480,12.975
2023-07-03,790525,123316,34174,89142,11.276
2023-07-11,811792,121682,38934,82748,10.193
2023-07-18,864390,130864,35050,95814,11.085
2023-07-25,859676,146398,25659,120739,14.045
2023-08-01,813382,123815,29322,94493,11.617
2023-08-08,802230,101533,37452,64081,7.988
2023-08-15,817683,91375,40656,50719,6.203
2023-08-22,845742,97385,39179,58206,6.882
2023-08-29,856057,118861,27876,90985,10.628
2023-09-05,875032,115366,32556,82810,9.464
2023-09-12,905855,112059,38244,73815,8.149
2023-09-19,955446,90628,44796,45832,4.797
2023-09-26,946573,81821,51763,30058,3.175
2023-10-03,994381,68593,63592,5001,0.503
2023-10-10,1021295,66420,64254,2166,0.212
2023-10-17,1037359,70287,72271,-1984,0.191
2023-10-24,1005083,73419,65666,7753,0.771
2023-10-31,813932,79822,56669,23153,2.845
2023-11-07,845550,106308,37710,68598,8.113
2023-11-14,878980,122174,34261,87913,10.002
2023-11-21,891751,117545,35958,81587,9.149
2023-11-28,865163,111598,44036,67562,7.809
2023-12-05,846078,91302,54669,36633,4.33
2023-12-12,849842,83281,52432,30849,3.63
2023-12-19,827119,73229,62963,10266,1.241
2023-12-26,752705,70617,65850,4767,0.633
2024-01-02,789479,69804,81433,-11629,1.473
2024-01-09,833627,64373,95621,-31248,3.748
2024-01-16,874503,53776,130573,-76797,8.782
2024-01-23,931391,47965,139807,-91842,9.861
2024-01-30,956224,42509,150756,-108247,11.32
2024-02-06,991437,44368,174668,-130300,13.143
2024-02-13,1005227,49048,183548,-134500,13.38
2024-02-20,1037578,51617,188294,-136677,13.173
2024-02-27,922159,48217,208870,-160653,17.421
2024-03-05,927931,52457,224456,-171999,18.536
2024-03-12,951826,56290,211427,-155137,16.299
2024-03-19,995024,56166,204505,-148339,14.908
2024-03-26,1022662,58747,193527,-134780,13.179
2024-04-02,1054786,57412,195668,-138256,13.107
2024-04-09,1064875,54057,193367,-139310,13.082
2024-04-16,1126772,45089,212964,-167875,14.899
2024-04-23,1057438,47245,196259,-149014,14.092
2024-04-30,911168,51967,201203,-149236,16.379
2024-05-07,954273,79591,121044,-41453,4.344
2024-05-14,966137,69291,111956,-42665,4.416
2024-05-21,1006051,73099,99525,-26426,2.627
2024-05-28,1007496,80866,95084,-14218,1.411
2024-06-04,1074413,72494,132235,-59741,5.56
2024-06-11,1056572,71529,147409,-75880,7.182
