Report_Date,Open_Interest_All,MM_Long_All,MM_Short_All,Net_Position,Percent_of_OpenInterest
2006-06-13,574241,73239,44193,29046,5.058
2006-06-20,555313,59513,43068,16445,2.961
2006-06-27,512823,56292,44000,12292,2.397
2006-07-03,512860,57993,49477,8516,1.66
2006-07-11,527642,64797,44927,19870,3.766
2006-07-18,530072,69219,40292,28927,5.457
2006-07-25,536928,69905,38269,31636,5.892
2006-08-01,540095,64911,41941,22970,4.253
2006-08-08,525146,65863,43093,22770,4.336
2006-08-15,514412,59180,49868,9312,1.81
2006-08-22,512816,49534,64124,-14590,2.845
2006-08-29,495137,52349,60559,-8210,1.658
2006-09-05,500500,50866,45494,5372,1.073
2006-09-12,500192,54690,49868,4822,0.964
2006-09-19,507320,49400,52135,-2735,0.539
2006-09-26,524294,53315,47866,5449,1.039
2006-10-03,571645,68935,40961,27974,4.894
2006-10-10,585610,77293,35265,42028,7.177
2006-10-17,612748,80174,32626,47548,7.76
2006-10-24,601882,77745,31922,45823,7.613
2006-10-31,566127,74103,31600,42503,7.508
2006-11-07,569489,71438,29742,41696,7.322
2006-11-14,539737,66407,29984,36423,6.748
2006-11-21,479959,64362,32345,32017,6.671
2006-11-28,479316,64664,33810,30854,6.437
2006-12-05,488917,67188,31731,35457,7.252
2006-12-12,478840,57862,35341,22521,4.703
2006-12-19,488929,57535,38002,19533,3.995
2006-12-26,509375,61850,33602,28248,5.546
2007-01-03,513744,61748,41659,20089,3.91
2007-01-09,526032,55438,44235,11203,2.13
2007-01-16,527089,52993,45336,7657,1.453
2007-01-23,537962,57272,44303,12969,2.411
2007-01-30,526759,55145,49093,6052,1.149
2007-02-06,532827,55446,51824,3622,0.68
2007-02-13,524970,56739,50843,5896,1.123
2007-02-20,515071,57369,52000,5369,1.042
2007-02-27,492314,72091,49802,22289,4.527
2007-03-06,474051,61373,49471,11902,2.511
2007-03-13,478199,62287,50789,11498,2.404
2007-03-20,484551,60320,61415,-1095,0.226
2007-03-27,489379,63120,64746,-1626,0.332
2007-04-03,495554,54331,69770,-15439,3.116
2007-04-10,480306,59698,63139,-3441,0.716
2007-04-17,469860,62836,49247,13589,2.892
2007-04-24,445887,67642,47285,20357,4.566
2007-05-01,452753,71841,51725,20116,4.443
2007-05-08,448225,67589,50573,17016,3.796
2007-05-15,461876,65602,51581,14021,3.036
2007-05-22,445752,59856,53227,6629,1.487
2007-05-29,451853,61980,49838,12142,2.687
2007-06-05,494312,76637,45326,31311,6.334
2007-06-12,503339,83536,41477,42059,8.356
2007-06-19,528433,92325,40916,51409,9.729
2007-06-26,495176,96953,41064,55889,11.287
2007-07-03,466463,87923,44899,43024,9.223
2007-07-10,482873,89533,44741,44792,9.276
2007-07-17,499203,91807,48942,42865,8.587
2007-07-24,524336,91120,49165,41955,8.002
2007-07-31,525529,92707,51389,41318,7.862
2007-08-07,524539,97108,48578,48530,9.252
2007-08-14,524094,95237,40328,54909,10.477
2007-08-21,504474,89330,43428,45902,9.099
2007-08-28,473334,86936,37783,49153,10.384
2007-09-04,479068,83923,34208,49715,10.377
2007-09-11,500032,80388,41470,38918,7.783
2007-09-18,508987,78935,45263,33672,6.615
2007-09-25,514428,78344,44503,33841,6.578
2007-10-02,533578,78001,48160,29841,5.593
2007-10-09,536739,74676,46727,27949,5.207
2007-10-16,538132,72378,46417,25961,4.824
2007-10-23,551037,71025,47345,23680,4.297
2007-10-30,558330,72240,45532,26708,4.784
2007-11-06,562246,71948,47508,24440,4.347
2007-11-13,565082,68754,48782,19972,3.534
2007-11-20,474922,69454,49923,19531,4.112
2007-11-27,485252,70145,47150,22995,4.739
2007-12-04,503958,75367,50881,24486,4.859
2007-12-11,529374,78083,55318,22765,4.3
2007-12-18,543158,76396,49250,27146,4.998
2007-12-24,540934,76965,49683,27282,5.043
2007-12-31,540679,73522,46984,26538,4.908
2008-01-08,564118,74332,48929,25403,4.503
2008-01-15,578008,87543,45855,41688,7.212
2008-01-22,586730,83077,43840,39237,6.687
2008-01-29,591931,78951,41841,37110,6.269
2008-02-05,610288,80966,41037,39929,6.543
2008-02-12,607963,86313,46734,39579,6.51
2008-02-19,606226,85788,45755,40033,6.604
2008-02-26,563215,86230,41139,45091,8.006
2008-03-04,532905,79445,39349,40096,7.524
2008-03-11,558425,79057,34515,44542,7.976
2008-03-18,563305,75679,31935,43744,7.766
2008-03-25,543520,74022,29766,44256,8.142
2008-04-01,534649,73581,26202,47379,8.862
2008-04-08,534053,71547,29538,42009,7.866
2008-04-15,535557,71298,35613,35685,6.663
2008-04-22,531768,71626,34572,37054,6.968
2008-04-29,497690,70884,36965,33919,6.815
2008-05-06,499507,72863,44087,28776,5.761
2008-05-13,501180,70736,49631,21105,4.211
2008-05-20,509629,70970,54223,16747,3.286
2008-05-27,500407,63667,54970,8697,1.738
2008-06-03,508301,66247,52144,14103,2.775
2008-06-10,503348,71040,56844,14196,2.82
2008-06-17,506539,70956,50534,20422,4.032
2008-06-24,440593,70096,46151,23945,5.435
2008-07-01,444081,66630,42813,23817,5.363
2008-07-08,433127,61184,49299,11885,2.744
2008-07-15,437914,61858,54712,7146,1.632
2008-07-22,438234,63510,52812,10698,2.441
2008-07-29,436309,61299,54270,7029,1.611
2008-08-05,449902,62106,49562,12544,2.788
2008-08-12,442906,60633,47996,12637,2.853
2008-08-19,437858,60063,39673,20390,4.657
2008-08-26,418187,60898,36490,24408,5.837
2008-09-02,403994,57540,44271,13269,3.284
2008-09-09,402033,53255,46337,6918,1.721
2008-09-16,419486,51119,53778,-2659,0.634
2008-09-23,404906,49083,47466,1617,0.399
2008-09-30,402722,49069,46316,2753,0.684
2008-10-07,415737,48382,49470,-1088,0.262
2008-10-14,423223,44949,46363,-1414,0.334
2008-10-21,431474,45196,46635,-1439,0.334
2008-10-28,430190,43409,42055,1354,0.315
2008-11-04,434511,46709,39405,7304,1.681
2008-11-11,440958,42163,40443,1720,0.39
2008-11-18,447612,45908,42825,3083,0.689
2008-11-25,323676,45379,41349,4030,1.245
2008-12-02,313429,44940,45689,-749,0.239
2008-12-09,319843,44743,52212,-7469,2.335
2008-12-16,326010,47427,44056,3371,1.034
2008-12-22,321218,48573,43891,4682,1.458
2008-12-30,321795,48157,39039,9118,2.833
2009-01-06,345164,50490,36589,13901,4.027
2009-01-13,352949,50624,40957,9667,2.739
2009-01-20,358382,48599,48727,-128,0.036
2009-01-27,366634,49682,43646,6036,1.646
2009-02-03,370711,49016,42939,6077,1.639
2009-02-10,394648,51616,48592,3024,0.766
2009-02-17,407203,50372,53171,-2799,0.687
2009-02-24,360625,50497,56002,-5505,1.527
2009-03-03,357899,50415,59879,-9464,2.644
2009-03-10,370160,50082,56635,-6553,1.77
2009-03-17,390190,52795,51674,1121,0.287
2009-03-24,397450,52853,49220,3633,0.914
2009-03-31,412485,53647,57341,-3694,0.896
2009-04-07,417105,54265,46805,7460,1.789
2009-04-14,409932,53130,50781,2349,0.573
2009-04-21,409641,53229,59746,-6517,1.591
2009-04-28,384367,55974,58364,-2390,0.622
2009-05-05,375260,63866,50354,13512,3.601
2009-05-12,393948,70998,44751,26247,6.663
2009-05-19,393363,72833,40623,32210,8.188
2009-05-26,405023,77511,38618,38893,9.603
2009-06-02,460079,89963,42314,47649,10.357
2009-06-09,450856,78802,40544,38258,8.486
2009-06-16,451713,75225,43928,31297,6.929
2009-06-23,446062,67763,48834,18929,4.244
2009-06-30,383387,72187,58911,13276,3.463
2009-07-07,393654,66121,67089,-968,0.246
2009-07-14,392282,61494,71006,-9512,2.425
2009-07-21,402826,65003,71485,-6482,1.609
2009-07-28,407456,63754,72616,-8862,2.175
2009-08-04,403715,65537,69835,-4298,1.065
2009-08-11,415470,65395,77821,-12426,2.991
2009-08-18,427163,58920,78439,-19519,4.569
2009-08-25,407871,60673,74733,-14060,3.447
2009-09-01,390847,60556,78291,-17735,4.538
2009-09-08,398401,59125,78813,-19688,4.942
2009-09-15,409544,62298,74924,-12626,3.083
2009-09-22,422340,63200,75615,-12415,2.94
2009-09-29,430896,62377,74347,-11970,2.778
2009-10-06,430167,65966,77902,-11936,2.775
2009-10-13,437564,67477,65802,1675,0.383
2009-10-20,440028,66605,57829,8776,1.994
2009-10-27,442320,64664,53909,10755,2.431
2009-11-03,446949,59702,53213,6489,1.452
2009-11-09,460257,55935,53575,2360,0.513
2009-11-17,495040,61777,44005,17772,3.59
2009-11-24,418881,65064,42065,22999,5.491
2009-12-01,421702,63503,40512,22991,5.452
2009-12-08,421790,61511,42756,18755,4.447
2009-12-15,435402,60621,50249,10372,2.382
2009-12-22,440022,56465,65556,-9091,2.066
2009-12-29,437771,57904,66587,-8683,1.983
2010-01-05,436329,58906,61826,-2920,0.669
2010-01-12,459440,60648,70287,-9639,2.098
2010-01-19,482540,59559,78431,-18872,3.911
2010-01-26,492798,59051,92938,-33887,6.876
2010-02-02,522399,57302,96609,-39307,7.524
2010-02-09,532716,57276,106850,-49574,9.306
2010-02-16,546969,60728,99262,-38534,7.045
2010-02-23,492782,59335,96169,-36834,7.475
2010-03-02,492740,60229,92968,-32739,6.644
2010-03-09,499684,59283,92130,-32847,6.574
2010-03-16,511010,57289,96838,-39549,7.739
2010-03-23,520609,56657,97590,-40933,7.863
2010-03-30,532156,56318,105514,-49196,9.245
2010-04-06,552871,56458,106875,-50417,9.119
2010-04-13,556555,57149,100016,-42867,7.702
2010-04-20,544611,61068,90007,-28939,5.314
2010-04-27,528700,59440,84867,-25427,4.809
2010-05-04,533185,61943,77630,-15687,2.942
2010-05-11,539719,59987,75231,-15244,2.824
2010-05-18,554463,59553,88696,-29143,5.256
2010-05-25,575689,59084,96717,-37633,6.537
2010-06-01,590807,56770,99885,-43115,7.298
2010-06-08,605582,59238,100768,-41530,6.858
2010-06-15,611821,60061,107587,-47526,7.768
2010-06-22,577675,61512,94646,-33134,5.736
2010-06-29,518643,63931,92849,-28918,5.576
2010-07-06,526936,63289,71855,-8566,1.626
2010-07-13,555231,67925,57435,10490,1.889
2010-07-20,583891,72577,47458,25119,4.302
2010-07-27,596686,75788,41498,34290,5.747
2010-08-03,639659,75100,38982,36118,5.646
2010-08-10,666521,77075,36243,40832,6.126
2010-08-17,656550,83676,36568,47108,7.175
2010-08-24,666905,85758,37818,47940,7.188
2010-08-31,578381,84440,38778,45662,7.895
2010-09-07,602120,89276,39976,49300,8.188
2010-09-14,619175,90887,41041,49846,8.05
2010-09-21,620197,83842,43852,39990,6.448
2010-09-28,616141,76085,49335,26750,4.342
2010-10-05,624832,69573,53376,16197,2.592
2010-10-12,649033,71593,59679,11914,1.836
2010-10-19,652769,68145,60246,7899,1.21
2010-10-26,660009,73020,59168,13852,2.099
2010-11-02,662361,79481,60388,19093,2.883
2010-11-09,672609,79704,60816,18888,2.808
2010-11-16,634365,61989,68655,-6666,1.051
2010-11-23,626413,57728,64611,-6883,1.099
2010-11-30,525597,57073,63986,-6913,1.315
2010-12-07,582777,77181,51903,25278,4.338
2010-12-14,583067,80433,47838,32595,5.59
2010-12-21,591973,78645,46479,32166,5.434
2010-12-28,596899,83331,46789,36542,6.122
2011-01-04,609012,84009,45071,38938,6.394
2011-01-11,616244,81537,44458,37079,6.017
2011-01-18,633208,79402,47468,31934,5.043
2011-01-25,669836,91802,47930,43872,6.55
2011-02-01,684217,93271,49863,43408,6.344
2011-02-08,722923,98641,46854,51787,7.164
2011-02-15,698258,90063,50022,40041,5.734
2011-02-22,626895,74447,57397,17050,2.72
2011-03-01,609322,65544,48074,17470,2.867
2011-03-08,614599,65570,44613,20957,3.41
2011-03-15,636214,67204,45273,21931,3.447
2011-03-22,625992,62592,49011,13581,2.17
2011-03-29,625863,62790,48577,14213,2.271
2011-04-05,642134,67778,43685,24093,3.752
2011-04-12,633461,67965,41604,26361,4.161
2011-04-19,628819,72809,45206,27603,4.39
2011-04-26,592679,79451,43183,36268,6.119
2011-05-03,578531,79149,49399,29750,5.142
2011-05-10,580373,76066,51930,24136,4.159
2011-05-17,579090,67004,55798,11206,1.935
2011-05-24,581523,72672,44075,28597,4.918
2011-05-31,582926,72653,39994,32659,5.603
2011-06-07,584243,66520,46066,20454,3.501
2011-06-14,577958,64516,56958,7558,1.308
2011-06-21,602487,61438,70008,-8570,1.422
2011-06-28,522822,63049,69706,-6657,1.273
2011-07-05,536561,61649,76946,-15297,2.851
2011-07-12,541783,60975,70681,-9706,1.791
2011-07-19,535772,61979,66294,-4315,0.805
2011-07-26,526288,59671,69831,-10160,1.931
2011-08-02,538933,61211,73100,-11889,2.206
2011-08-09,534448,60834,73514,-12680,2.373
2011-08-16,547399,65455,68254,-2799,0.511
2011-08-23,550790,68869,64490,4379,0.795
2011-08-30,491397,66875,53218,13657,2.779
2011-09-06,482921,63846,50351,13495,2.794
2011-09-13,490790,56674,67824,-11150,2.272
2011-09-20,508587,56423,81331,-24908,4.897
2011-09-27,513744,54340,90555,-36215,7.049
2011-10-04,526548,53741,85698,-31957,6.069
2011-10-11,524518,53644,83949,-30305,5.778
2011-10-18,541878,54759,92610,-37851,6.985
2011-10-25,537170,59045,87720,-28675,5.338
2011-11-01,543834,57613,93153,-35540,6.535
2011-11-08,535772,57795,83952,-26157,4.882
2011-11-15,522496,55634,92486,-36852,7.053
2011-11-22,514755,51874,102456,-50582,9.826
2011-11-29,416371,52862,96065,-43203,10.376
2011-12-06,429051,60170,98848,-38678,9.015
2011-12-13,434641,57412,100461,-43049,9.904
2011-12-20,444998,59188,101076,-41888,9.413
2011-12-27,451421,60895,90147,-29252,6.48
2012-01-03,463614,58681,85778,-27097,5.845
2012-01-10,484495,57875,93544,-35669,7.362
2012-01-17,519752,55221,104717,-49496,9.523
2012-01-24,547226,65566,114431,-48865,8.93
2012-01-31,550005,74232,105936,-31704,5.764
2012-02-07,544753,68310,99179,-30869,5.667
2012-02-14,529906,68132,112573,-44441,8.387
2012-02-21,549844,68620,125886,-57266,10.415
2012-02-28,513096,72527,120523,-47996,9.354
2012-03-06,513529,73357,100001,-26644,5.188
2012-03-13,525871,70844,110658,-39814,7.571
2012-03-20,542006,73002,106545,-33543,6.189
2012-03-27,545301,74343,105735,-31392,5.757
2012-04-03,580296,77750,109767,-32017,5.517
2012-04-10,581365,75512,117976,-42464,7.304
2012-04-17,584831,72631,124971,-52340,8.95
2012-04-24,552704,80873,122989,-42116,7.62
2012-05-01,524875,87249,112276,-25027,4.768
2012-05-08,539421,83583,129770,-46187,8.562
2012-05-15,541852,83475,133532,-50057,9.238
2012-05-22,545554,82724,75698,7026,1.288
2012-05-29,546285,85835,70250,15585,2.853
2012-06-05,550696,86872,89421,-2549,0.463
2012-06-12,541758,91023,97390,-6367,1.175
2012-06-19,543269,94197,99379,-5182,0.954
2012-06-26,509752,106848,66654,40194,7.885
2012-07-03,541794,108181,54771,53410,9.858
2012-07-10,570102,114379,51911,62468,10.957
2012-07-17,623717,123899,51224,72675,11.652
2012-07-24,652469,129689,50040,79649,12.207
2012-07-31,635641,130831,52919,77912,12.257
2012-08-07,638620,133421,52594,80827,12.657
2012-08-14,621040,130098,52994,77104,12.415
2012-08-21,648534,131476,54715,76761,11.836
2012-08-28,576076,127204,58620,68584,11.905
2012-09-04,584996,133941,61520,72421,12.38
2012-09-11,589518,134151,65177,68974,11.7
2012-09-18,600714,129350,68809,60541,10.078
2012-09-25,596617,128246,62938,65308,10.946
2012-10-02,602272,121438,63241,58197,9.663
2012-10-09,600139,113211,65433,47778,7.961
2012-10-16,605344,107658,62267,45391,7.498
2012-10-23,606751,116134,60865,55269,9.109
2012-10-30,602585,113675,65165,48510,8.05
2012-11-06,607813,110972,62541,48431,7.968
2012-11-13,636334,117711,67216,50495,7.935
2012-11-20,638623,100261,68211,32050,5.019
2012-11-27,521903,106054,62831,43223,8.282
2012-12-04,508698,95713,61284,34429,6.768
2012-12-11,516840,88208,76989,11219,2.171
2012-12-18,528529,83951,90384,-6433,1.217
2012-12-24,532424,80998,92897,-11899,2.235
2012-12-31,548370,78991,98142,-19151,3.492
2013-01-08,579623,80047,97882,-17835,3.077
2013-01-15,571418,77983,95901,-17918,3.136
2013-01-22,575407,77692,98600,-20908,3.634
2013-01-29,562941,81189,98865,-17676,3.14
2013-02-05,584442,89848,117524,-27676,4.735
2013-02-12,616980,84103,116518,-32415,5.254
2013-02-19,612444,74906,124129,-49223,8.037
2013-02-26,543875,76810,122176,-45366,8.341
2013-03-05,563026,80798,127084,-46286,8.221
2013-03-12,585424,85223,126742,-41519,7.092
2013-03-19,577068,87440,120897,-33457,5.798
2013-03-26,586145,92566,114348,-21782,3.716
2013-04-02,583881,80560,115586,-35026,5.999
2013-04-09,588563,84853,106947,-22094,3.754
2013-04-16,590154,80906,108084,-27178,4.605
2013-04-23,582612,82143,103013,-20870,3.582
2013-04-30,534939,88469,94248,-5779,1.08
2013-05-07,541317,82194,92638,-10444,1.929
2013-05-14,532701,81048,98273,-17225,3.234
2013-05-21,544873,77401,117848,-40447,7.423
2013-05-28,537254,78275,114442,-36167,6.732
2013-06-04,546503,88031,105630,-17599,3.22
2013-06-11,536081,86731,103428,-16697,3.115
2013-06-18,539491,84096,113527,-29431,5.455
2013-06-25,476917,86915,106235,-19320,4.051
2013-07-02,511032,79373,129525,-50152,9.814
2013-07-09,501501,82385,130229,-47844,9.54
2013-07-16,499170,90080,124341,-34261,6.864
2013-07-23,506705,89501,138163,-48662,9.604
2013-07-30,503559,94436,135204,-40768,8.096
2013-08-06,512932,95983,143318,-47335,9.228
2013-08-13,532112,100792,144788,-43996,8.268
2013-08-20,517110,99127,142068,-42941,8.304
2013-08-27,458172,99162,129205,-30043,6.557
2013-09-03,447423,96388,134778,-38390,8.58
2013-09-10,447125,95228,142236,-47008,10.513
2013-09-17,449725,93005,143887,-50882,11.314
2013-09-24,450570,97825,132825,-35000,7.768
2013-10-01,454515,98059,94836,3223,0.709
2013-10-08,466026,104977,84928,20049,4.302
2013-10-15,465737,104323,82247,22076,4.74
2013-10-22,479860,109146,79943,29203,6.086
2013-10-29,455749,100828,87889,12939,2.839
2013-11-05,459736,87305,106840,-19535,4.249
2013-11-12,500998,90980,138231,-47251,9.431
2013-11-19,518009,91741,146940,-55199,10.656
2013-11-26,450072,93726,159767,-66041,14.673
2013-12-03,453589,91449,155462,-64013,14.113
2013-12-10,465509,86654,156115,-69461,14.922
2013-12-17,488060,85049,156763,-71714,14.694
2013-12-24,503814,87351,157183,-69832,13.861
2013-12-31,500015,87711,159179,-71468,14.293
2014-01-07,508765,88068,161156,-73088,14.366
2014-01-14,537899,93902,150384,-56482,10.5
2014-01-21,572239,91725,148296,-56571,9.886
2014-01-28,571942,90807,153308,-62501,10.928
2014-02-04,570981,96132,149095,-52963,9.276
2014-02-11,569751,94785,138010,-43225,7.587
2014-02-18,556645,90342,124744,-34402,6.18
2014-02-25,473752,84841,105152,-20311,4.287
2014-03-04,452194,84443,90483,-6040,1.336
2014-03-11,458963,88188,77673,10515,2.291
2014-03-18,492513,90107,66071,24036,4.88
2014-03-25,504890,97076,60584,36492,7.228
2014-04-01,511982,98564,53539,45025,8.794
2014-04-08,524939,99192,56003,43189,8.227
2014-04-15,523421,93059,54849,38210,7.3
2014-04-22,517972,86201,59111,27090,5.23
2014-04-29,465439,97338,54748,42590,9.151
2014-05-06,480934,97097,51832,45265,9.412
2014-05-13,490108,99995,54688,45307,9.244
2014-05-20,504797,91698,67262,24436,4.841
2014-05-27,502691,92130,72415,19715,3.922
2014-06-03,524221,82450,81413,1037,0.198
2014-06-10,546175,70794,97929,-27135,4.968
2014-06-17,560434,68677,97619,-28942,5.164
2014-06-24,457050,69003,109439,-40436,8.847
2014-07-01,458579,73248,113962,-40714,8.878
2014-07-08,484655,74180,118476,-44296,9.14
2014-07-15,524137,70256,116751,-46495,8.871
2014-07-22,550730,73852,128371,-54519,9.899
2014-07-29,552879,72708,144676,-71968,13.017
2014-08-05,551200,75597,142630,-67033,12.161
2014-08-12,541583,75068,136192,-61124,11.286
2014-08-19,535554,77251,127919,-50668,9.461
2014-08-26,477908,79872,126670,-46798,9.792
2014-09-02,467810,78577,130437,-51860,11.086
2014-09-09,488155,75523,137409,-61886,12.678
2014-09-16,516580,73725,140991,-67266,13.021
2014-09-23,554993,75121,154049,-78928,14.221
2014-09-30,551297,81075,152376,-71301,12.933
2014-10-07,548921,80662,148632,-67970,12.382
2014-10-14,546174,80673,140736,-60063,10.997
2014-10-21,545024,79809,130856,-51047,9.366
2014-10-28,541423,81682,124962,-43280,7.994
2014-11-04,536005,82969,114486,-31517,5.88
2014-11-11,530928,80232,111367,-31135,5.864
2014-11-18,533235,83241,95122,-11881,2.228
2014-11-25,426786,82627,94730,-12103,2.836
2014-12-02,461562,85042,89157,-4115,0.892
2014-12-09,464881,91896,87244,4652,1.001
2014-12-16,491303,93825,78531,15294,3.113
2014-12-23,509223,97500,75207,22293,4.378
2014-12-30,472346,96601,76120,20481,4.336
2015-01-06,477441,92676,78534,14142,2.962
2015-01-13,482791,82092,72662,9430,1.953
2015-01-20,507512,74386,76848,-2462,0.485
2015-01-27,500478,71366,83392,-12026,2.403
2015-02-03,553352,72447,99816,-27369,4.946
2015-02-10,548718,68726,94095,-25369,4.623
2015-02-17,535012,72322,98571,-26249,4.906
2015-02-24,489298,72683,104921,-32238,6.589
2015-03-03,507390,57538,113953,-56415,11.119
2015-03-10,544748,54162,121573,-67411,12.375
2015-03-17,557266,56932,124481,-67549,12.122
2015-03-24,561353,55358,121323,-65965,11.751
2015-03-31,552428,53620,124111,-70491,12.76
2015-04-07,569645,54486,125373,-70887,12.444
2015-04-14,593319,54328,136450,-82122,13.841
2015-04-21,587111,50284,146908,-96624,16.458
2015-04-28,546771,51752,158665,-106913,19.554
2015-05-05,569992,51174,162583,-111409,19.546
2015-05-12,572525,52251,156940,-104689,18.285
2015-05-19,563564,62480,135479,-72999,12.953
2015-05-26,563419,62458,145793,-83335,14.791
2015-06-02,575687,65275,136948,-71673,12.45
2015-06-09,593389,75416,106184,-30768,5.185
2015-06-16,591604,67273,110755,-43482,7.35
2015-06-23,573536,60256,112972,-52716,9.191
2015-06-30,514245,85628,71522,14106,2.743
2015-07-07,528769,96522,62152,34370,6.5
2015-07-14,537535,96887,64466,32421,6.031
2015-07-21,545092,90341,69736,20605,3.78
2015-07-28,500486,75001,69902,5099,1.019
2015-08-04,539263,70695,84737,-14042,2.604
2015-08-11,539079,72852,85502,-12650,2.347
2015-08-18,535111,74933,78470,-3537,0.661
2015-08-25,446800,69046,76263,-7217,1.615
2015-09-01,452412,58330,85333,-27003,5.969
2015-09-08,459768,50936,98396,-47460,10.323
2015-09-15,471542,57715,97097,-39382,8.352
2015-09-22,468079,59236,94601,-35365,7.555
2015-09-29,447755,57443,84091,-26648,5.951
2015-10-06,463456,64998,76947,-11949,2.578
2015-10-13,461422,61956,78482,-16526,3.582
2015-10-20,483373,51204,103470,-52266,10.813
2015-10-27,477897,61949,95213,-33264,6.96
2015-11-03,477596,67043,85284,-18241,3.819
2015-11-10,481818,63232,84177,-20945,4.347
2015-11-17,501848,55306,96715,-41409,8.251
2015-11-24,429522,53747,101100,-47353,11.025
2015-12-01,442600,48714,126038,-77324,17.47
2015-12-08,425762,51794,122774,-70980,16.671
2015-12-15,411176,59678,107855,-48177,11.717
2015-12-22,435150,54047,121214,-67167,15.435
2015-12-29,436900,49365,132485,-83120,19.025
2016-01-05,491615,47803,143946,-96143,19.557
2016-01-12,506373,60470,131598,-71128,14.047
2016-01-19,500412,55490,125948,-70458,14.08
2016-01-26,486726,60655,111354,-50699,10.416
2016-02-02,502064,67534,116219,-48685,9.697
2016-02-09,547245,61665,142710,-81045,14.81
2016-02-16,564052,62638,147005,-84367,14.957
2016-02-23,510901,59066,157746,-98680,19.315
2016-03-01,526908,57740,165217,-107477,20.398
2016-03-08,529522,60186,152636,-92450,17.459
2016-03-15,524685,62686,130192,-67506,12.866
2016-03-22,535602,57610,139447,-81837,15.279
2016-03-29,534234,63062,132894,-69832,13.071
2016-04-05,553313,64268,132006,-67738,12.242
2016-04-12,591360,53407,159570,-106163,17.952
2016-04-19,593880,58511,146752,-88241,14.858
2016-04-26,506947,63822,124627,-60805,11.994
2016-05-03,501622,60700,122941,-62241,12.408
2016-05-10,518973,55828,134009,-78181,15.065
2016-05-17,503740,56712,129287,-72575,14.407
2016-05-24,505986,44609,134245,-89636,17.715
2016-05-31,506509,46399,137390,-90991,17.964
2016-06-07,524642,60434,113754,-53320,10.163
2016-06-14,528801,63714,111949,-48235,9.122
2016-06-21,533609,55652,118940,-63288,11.86
2016-06-28,469486,54888,136874,-81986,17.463
2016-07-05,520417,53372,155616,-102244,19.647
2016-07-12,545083,54737,169405,-114668,21.037
2016-07-19,567300,57225,173831,-116606,20.555
2016-07-26,561410,59891,190075,-130184,23.189
2016-08-02,585850,62813,191871,-129058,22.029
2016-08-09,551337,63819,182474,-118655,21.521
2016-08-16,543878,65286,171024,-105738,19.441
2016-08-23,556989,70518,174495,-103977,18.668
2016-08-30,526618,70043,191916,-121873,23.143
2016-09-06,547593,74225,206802,-132577,24.211
2016-09-13,556437,73515,198953,-125438,22.543
2016-09-20,555192,74957,202222,-127265,22.923
2016-09-27,555160,74844,206261,-131417,23.672
2016-10-04,573057,72075,223492,-151417,26.423
2016-10-11,580214,71775,207181,-135406,23.337
2016-10-18,585472,84334,186585,-102251,17.465
2016-10-25,598860,78251,201638,-123387,20.604
2016-11-01,601362,80108,190740,-110632,18.397
2016-11-08,610807,81476,192822,-111346,18.229
2016-11-15,635308,71127,203480,-132353,20.833
2016-11-22,627850,79744,193966,-114222,18.193
2016-11-29,520547,79495,198004,-118509,22.766
2016-12-06,537020,79575,195495,-115920,21.586
2016-12-13,546827,90763,183692,-92929,16.994
2016-12-20,553323,85196,188791,-103595,18.722
2016-12-27,549259,84840,193767,-108927,19.832
2017-01-03,563521,89362,192955,-103593,18.383
2017-01-10,585192,90164,175132,-84968,14.52
2017-01-17,613233,90549,175566,-85017,13.864
2017-01-24,603848,86072,174771,-88699,14.689
2017-01-31,599014,80474,179561,-99087,16.542
2017-02-07,589307,86932,169479,-82547,14.007
2017-02-14,607685,98126,138173,-40047,6.59
2017-02-21,586032,96446,123831,-27385,4.673
2017-02-28,475061,88342,143808,-55466,11.676
2017-03-07,503549,87563,150743,-63180,12.547
2017-03-14,547722,78034,178663,-100629,18.372
2017-03-21,591157,79140,200145,-121005,20.469
2017-03-28,605728,75261,211411,-136150,22.477
2017-04-04,616119,73476,212310,-138834,22.534
2017-04-11,613152,77506,211965,-134459,21.929
2017-04-18,620081,75475,217601,-142126,22.921
2017-04-25,594469,75341,237668,-162327,27.306
2017-05-02,557093,80603,205241,-124638,22.373
2017-05-09,531789,83822,191714,-107892,20.288
2017-05-16,558645,85525,206910,-121385,21.728
2017-05-23,566325,88831,202042,-113211,19.99
2017-05-30,566189,89304,203064,-113760,20.092
2017-06-06,576156,91969,198105,-106136,18.421
2017-06-13,556853,93101,175960,-82859,14.88
2017-06-20,588265,105363,126334,-20971,3.565
2017-06-27,480455,101380,111538,-10158,2.114
2017-07-03,547262,113929,95926,18003,3.29
2017-07-11,590898,121224,76539,44685,7.562
2017-07-18,581547,113138,77212,35926,6.178
2017-07-25,541295,101874,74024,27850,5.145
2017-08-01,563534,97730,85540,12190,2.163
2017-08-08,572828,91031,105132,-14101,2.462
2017-08-15,596902,85312,119548,-34236,5.736
2017-08-22,650366,81512,148263,-66751,10.264
2017-08-29,547694,82760,160289,-77529,14.156
2017-09-05,548879,85700,172270,-86570,15.772
2017-09-12,548631,85350,169095,-83745,15.264
2017-09-19,548266,91436,171004,-79568,14.513
2017-09-26,533550,94459,159158,-64699,12.126
2017-10-03,552053,97306,153781,-56475,10.23
2017-10-10,583852,98389,166118,-67729,11.6
2017-10-17,608080,93746,171438,-77692,12.777
2017-10-24,647209,93312,177277,-83965,12.973
2017-10-31,702662,90193,201068,-110875,15.779
2017-11-07,708502,85617,210702,-125085,17.655
2017-11-14,704038,92025,200601,-108576,15.422
2017-11-21,697047,94251,202917,-108666,15.589
2017-11-28,598396,93771,216545,-122774,20.517
2017-12-05,581401,93671,212452,-118781,20.43
2017-12-12,644349,86166,243818,-157652,24.467
2017-12-19,652326,90022,243599,-153577,23.543
2017-12-26,622514,86886,232621,-145735,23.411
2018-01-02,626431,90573,218751,-128178,20.462
2018-01-09,639461,91713,220703,-128990,20.172
2018-01-16,669281,88146,231085,-142939,21.357
2018-01-23,682931,84468,229876,-145408,21.292
2018-01-30,681306,88118,184881,-96763,14.203
2018-02-06,673598,91349,174743,-83394,12.38
2018-02-13,665032,86341,143172,-56831,8.546
2018-02-20,639559,85634,152673,-67039,10.482
2018-02-27,559662,83254,143886,-60632,10.834
2018-03-06,615814,85956,118487,-32531,5.283
2018-03-13,635650,79582,115166,-35584,5.598
2018-03-20,613525,67307,123414,-56107,9.145
2018-03-27,623639,65125,142877,-77752,12.467
2018-04-03,629801,67664,141082,-73418,11.657
2018-04-10,630569,74549,129421,-54872,8.702
2018-04-17,612485,75766,125904,-50138,8.186
2018-04-24,582582,75707,130420,-54713,9.391
2018-05-01,612147,91765,120467,-28702,4.689
2018-05-08,611968,101468,97142,4326,0.707
2018-05-15,605554,98109,103631,-5522,0.912
2018-05-22,652504,96817,98502,-1685,0.258
2018-05-29,696143,108100,92782,15318,2.2
2018-06-05,687020,104374,88088,16286,2.371
2018-06-12,699899,103530,88627,14903,2.129
2018-06-19,652757,94125,94877,-752,0.115
2018-06-26,589541,89897,102374,-12477,2.116
2018-07-03,595898,88121,90046,-1925,0.323
2018-07-10,598545,87423,87669,-246,0.041
2018-07-17,610468,88809,85252,3557,0.583
2018-07-24,599702,98912,74970,23942,3.992
2018-07-31,650116,117435,64503,52932,8.142
2018-08-07,678322,130472,65885,64587,9.522
2018-08-14,661149,130985,64037,66948,10.126
2018-08-21,660739,126158,65346,60812,9.204
2018-08-28,569779,109580,58400,51180,8.982
2018-09-04,577239,104433,61667,42766,7.409
2018-09-11,592719,92958,74543,18415,3.107
2018-09-18,616694,85009,86388,-1379,0.224
2018-09-25,585740,90617,91736,-1119,0.191
2018-10-02,613383,88059,100158,-12099,1.973
2018-10-09,621138,83867,100752,-16885,2.718
2018-10-16,630259,85458,102251,-16793,2.664
2018-10-23,636495,81586,107691,-26105,4.101
2018-10-30,687108,79107,123824,-44717,6.508
2018-11-06,682492,80802,121945,-41143,6.028
2018-11-13,623342,79481,106165,-26684,4.281
2018-11-20,603702,79392,117240,-37848,6.269
2018-11-27,528844,81948,120561,-38613,7.301
2018-12-04,523682,85367,113774,-28407,5.424
2018-12-11,518577,87468,109870,-22402,4.32
2018-12-18,538634,96638,102263,-5625,1.044
2018-12-24,521427,91243,108247,-17004,3.261
2018-12-31,542214,87826,119846,-32020,5.905
2019-01-08,547663,94047,110526,-16479,3.009
2019-01-15,551978,95895,111856,-15961,2.892
2019-01-22,564730,100659,110110,-9451,1.674
2019-01-29,572520,93123,115637,-22514,3.932
2019-02-05,583346,98796,107939,-9143,1.567
2019-02-12,577232,92461,108514,-16053,2.781
2019-02-19,614790,86612,129330,-42718,6.948
2019-02-26,567778,83730,142297,-58567,10.315
2019-03-05,602962,83155,155604,-72449,12.016
2019-03-12,655148,83573,155721,-72148,11.012
2019-03-19,650312,83317,156823,-73506,11.303
2019-03-26,618565,80072,143825,-63753,10.307
2019-04-02,621938,78527,134966,-56439,9.075
2019-04-09,597702,77505,131774,-54269,9.08
2019-04-16,602301,78122,141198,-63076,10.473
2019-04-23,613282,81159,149151,-67992,11.087
2019-04-30,579436,76062,159564,-83502,14.411
2019-05-07,588174,78768,160914,-82146,13.966
2019-05-14,620326,79658,158119,-78461,12.648
2019-05-21,600372,82498,124258,-41760,6.956
2019-05-28,595814,85706,109486,-23780,3.991
2019-06-04,604140,77633,90981,-13348,2.209
2019-06-11,587649,82392,80651,1741,0.296
2019-06-18,606510,90351,67638,22713,3.745
2019-06-25,496355,92918,61405,31513,6.349
2019-07-02,482398,96328,59231,37097,7.69
2019-07-09,486419,91887,61513,30374,6.244
2019-07-16,504375,82697,63946,18751,3.718
2019-07-23,523620,76505,64726,11779,2.25
2019-07-30,496762,79534,64924,14610,2.941
2019-08-06,527403,77057,70838,6219,1.179
2019-08-13,522159,75589,71501,4088,0.783
2019-08-20,526773,73496,74745,-1249,0.237
2019-08-27,445985,76086,79142,-3056,0.685
2019-09-03,448721,70046,91083,-21037,4.688
2019-09-10,465009,76930,91319,-14389,3.094
2019-09-17,458093,76303,88880,-12577,2.746
2019-09-24,446663,71168,89947,-18779,4.204
2019-10-01,468623,68809,90323,-21514,4.591
2019-10-08,492001,72951,92089,-19138,3.89
2019-10-15,516692,72563,83127,-10564,2.045
2019-10-22,541212,79531,67432,12099,2.236
2019-10-29,518097,71584,66542,5042,0.973
2019-11-05,525413,70017,70671,-654,0.124
2019-11-12,527940,75080,74689,391,0.074
2019-11-19,499389,75513,77562,-2049,0.41
2019-11-26,433889,78847,68372,10475,2.414
2019-12-03,450615,88748,68181,20567,4.564
2019-12-10,466224,87809,76206,11603,2.489
2019-12-17,513996,100043,75301,24742,4.814
2019-12-24,516306,97987,78838,19149,3.709
2019-12-31,524777,102855,75585,27270,5.196
2020-01-07,553359,109908,82221,27687,5.003
2020-01-14,604320,117055,87268,29787,4.929
2020-01-21,645472,129816,88145,41671,6.456
2020-01-28,630775,136325,87856,48469,7.684
2020-02-04,650138,135618,83457,52161,8.023
2020-02-11,634249,133713,87773,45940,7.243
2020-02-18,647497,143987,79272,64715,9.995
2020-02-25,557399,127451,85464,41987,7.533
2020-03-03,533295,92936,77532,15404,2.888
2020-03-10,546604,92687,76005,16682,3.052
2020-03-17,519290,60462,66121,-5659,1.09
2020-03-24,495295,62369,44699,17670,3.568
2020-03-31,494478,77333,41362,35971,7.275
2020-04-07,493604,75597,49432,26165,5.301
2020-04-14,504792,77290,51909,25381,5.028
2020-04-21,504116,80828,56827,24001,4.761
2020-04-28,453802,79713,63738,15975,3.52
2020-05-05,467969,72779,68939,3840,0.821
2020-05-12,474540,69947,66965,2982,0.628
2020-05-19,504512,64616,81092,-16476,3.266
2020-05-26,504578,69724,81928,-12204,2.419
2020-06-02,516193,70844,84316,-13472,2.61
2020-06-09,501935,65046,90414,-25368,5.054
2020-06-16,538242,60565,90816,-30251,5.62
2020-06-23,570036,56685,104898,-48213,8.458
2020-06-30,484999,59936,98748,-38812,8.002
2020-07-07,496820,62322,95851,-33529,6.749
2020-07-14,490448,72947,81274,-8327,1.698
2020-07-21,483480,81292,80818,474,0.098
2020-07-28,462888,83333,81634,1699,0.367
2020-08-04,479929,86382,85204,1178,0.245
2020-08-11,505974,74037,89569,-15532,3.07
2020-08-18,522554,74005,86479,-12474,2.387
2020-08-25,435469,76315,74798,1517,0.348
2020-09-01,460359,93329,60860,32469,7.053
2020-09-08,466640,87956,64781,23175,4.966
2020-09-15,462819,83377,68265,15112,3.265
2020-09-22,493573,84689,70146,14543,2.946
2020-09-29,464516,81101,68677,12424,2.675
2020-10-06,520547,91669,61333,30336,5.828
2020-10-13,536508,96311,57721,38590,7.193
2020-10-20,592895,108289,58561,49728,8.387
2020-10-27,582882,115243,66347,48896,8.389
2020-11-03,593222,110670,62065,48605,8.193
2020-11-10,577112,103271,70638,32633,5.655
2020-11-17,561714,89169,74755,14414,2.566
2020-11-24,491512,89078,73779,15299,3.113
2020-12-01,475976,79310,83707,-4397,0.924
2020-12-08,470281,78113,83805,-5692,1.21
2020-12-15,472648,78563,71891,6672,1.412
2020-12-21,479170,78554,72321,6233,1.301
2020-12-29,477257,84113,70753,13360,2.799
2021-01-05,522434,93771,68561,25210,4.825
2021-01-12,538192,89831,72844,16987,3.156
2021-01-19,565381,93799,73181,20618,3.647
2021-01-26,568469,91330,70055,21275,3.743
2021-02-02,565737,88517,68633,19884,3.515
2021-02-09,557908,85330,66024,19306,3.46
2021-02-16,561553,88564,67279,21285,3.79
2021-02-23,516298,92589,65679,26910,5.212
2021-03-02,510549,96522,64719,31803,6.229
2021-03-09,503536,89625,62049,27576,5.476
2021-03-16,512754,85274,67749,17525,3.418
2021-03-23,515700,83663,75503,8160,1.582
2021-03-30,511903,76681,91392,-14711,2.874
2021-04-06,500331,79392,86975,-7583,1.516
2021-04-13,528463,80376,93593,-13217,2.501
2021-04-20,548563,86787,85204,1583,0.289
2021-04-27,548366,92483,79084,13399,2.443
2021-05-04,544240,88367,77644,10723,1.97
2021-05-11,547075,87432,74399,13033,2.382
2021-05-18,536423,87980,73940,14040,2.617
2021-05-25,510434,79731,75197,4534,0.888
2021-06-01,510166,73716,70489,3227,0.633
2021-06-08,524595,67632,69006,-1374,0.262
2021-06-15,532513,68072,76468,-8396,1.577
2021-06-22,497031,70278,67263,3015,0.607
2021-06-29,417177,67906,67132,774,0.186
2021-07-06,410630,64991,78608,-13617,3.316
2021-07-13,416511,64066,87702,-23636,5.675
2021-07-20,435316,68139,71909,-3770,0.866
2021-07-27,424737,69943,66876,3067,0.722
2021-08-03,464439,79168,63860,15308,3.296
2021-08-10,476360,82432,63305,19127,4.015
2021-08-17,494409,93691,69506,24185,4.892
2021-08-24,498801,89079,77097,11982,2.402
2021-08-31,446666,81355,69985,11370,2.546
2021-09-07,443677,77816,72649,5167,1.165
2021-09-14,434267,66011,72016,-6005,1.383
2021-09-21,431266,61348,66839,-5491,1.273
2021-09-28,430091,60470,70285,-9815,2.282
2021-10-05,459518,72279,67067,5212,1.134
2021-10-12,470730,69443,77989,-8546,1.815
2021-10-19,487060,67819,85557,-17738,3.642
2021-10-26,495860,72264,80883,-8619,1.738
2021-11-02,527595,79448,73548,5900,1.118
2021-11-09,523259,81606,78278,3328,0.636
2021-11-16,565036,89466,74208,15258,2.7
2021-11-23,586045,93370,75407,17963,3.065
2021-11-30,449530,84655,78455,6200,1.379
2021-12-07,440731,78572,77851,721,0.164
2021-12-14,444225,72693,79996,-7303,1.644
2021-12-21,444789,67821,78828,-11007,2.475
2021-12-28,433728,67828,79601,-11773,2.714
2022-01-04,439485,64377,84222,-19845,4.516
2022-01-11,455595,59187,86951,-27764,6.094
2022-01-18,468778,63293,88194,-24901,5.312
2022-01-25,498029,71720,85147,-13427,2.696
2022-02-01,492052,64915,91367,-26452,5.376
2022-02-08,486477,64242,93794,-29552,6.075
2022-02-15,511039,64557,99215,-34658,6.782
2022-02-22,471913,72618,90671,-18053,3.825
2022-03-01,508287,78058,85094,-7036,1.384
2022-03-08,518859,86685,66477,20208,3.895
2022-03-15,513596,84797,61852,22945,4.468
2022-03-22,518617,85613,66102,19511,3.762
2022-03-29,471606,86013,66574,19439,4.122
2022-04-05,480453,85108,71149,13959,2.905
2022-04-12,486821,89933,73294,16639,3.418
2022-04-19,484604,90654,76184,14470,2.986
2022-04-26,431253,86374,72194,14180,3.288
2022-05-03,425804,83033,72127,10906,2.561
2022-05-10,424000,86968,71421,15547,3.667
2022-05-17,483434,97063,70477,26586,5.499
2022-05-24,453693,93178,70924,22254,4.905
2022-05-31,454385,88427,73403,15024,3.306
2022-06-07,462463,82327,69652,12675,2.741
2022-06-14,465751,77203,70264,6939,1.49
2022-06-21,453012,73925,69990,3935,0.869
2022-06-28,375548,68136,67116,1020,0.272
2022-07-05,387076,63267,63309,-42,0.011
2022-07-12,398172,58096,64540,-6444,1.618
2022-07-19,411445,61465,68281,-6816,1.657
2022-07-26,404440,62552,72943,-10391,2.569
2022-08-02,422808,67214,82184,-14970,3.541
2022-08-09,429529,66105,86453,-20348,4.737
2022-08-16,420327,69145,87252,-18107,4.308
2022-08-23,432194,65798,91867,-26069,6.032
2022-08-30,362465,68032,90279,-22247,6.138
2022-09-06,363699,66039,87470,-21431,5.893
2022-09-13,373189,63720,84106,-20386,5.463
2022-09-20,387820,64785,80488,-15703,4.049
2022-09-27,377966,58681,73078,-14397,3.809
2022-10-04,391177,53936,66155,-12219,3.124
2022-10-11,410978,54203,73705,-19502,4.745
2022-10-18,404388,52790,74841,-22051,5.453
2022-10-25,411948,52135,88187,-36052,8.752
2022-11-01,435024,57191,94340,-37149,8.54
2022-11-08,443703,55118,98020,-42902,9.669
2022-11-15,448452,53047,99827,-46780,10.431
2022-11-22,443433,52982,106384,-53402,12.043
2022-11-29,367782,54390,108458,-54068,14.701
2022-12-06,404705,57655,121037,-63382,15.661
2022-12-13,405051,58245,121249,-63004,15.555
2022-12-20,402381,55975,115286,-59311,14.74
2022-12-27,387675,55456,111668,-56212,14.5
2023-01-03,388172,54693,107408,-52715,13.58
2023-01-10,394847,54027,117161,-63134,15.989
2023-01-17,405665,53729,118818,-65089,16.045
2023-01-24,419670,53302,127235,-73933,17.617
2023-01-31,414563,56327,119955,-63628,15.348
2023-02-07,428529,53641,125032,-71391,16.66
2023-02-14,457528,54086,114043,-59957,13.105
2023-02-21,441354,51236,123281,-72045,16.324
2023-02-28,407327,51307,142948,-91641,22.498
2023-03-07,432751,57011,157647,-100636,23.255
2023-03-14,459299,61443,156700,-95257,20.74
2023-03-21,454791,61668,148168,-86500,19.02
2023-03-28,446151,57274,147147,-89873,20.144
2023-04-04,449495,56809,143892,-87083,19.374
2023-04-11,469091,56306,160553,-104247,22.223
2023-04-18,458928,60545,163528,-102983,22.44
2023-04-25,429579,58225,171237,-113012,26.308
2023-05-02,462482,58776,185100,-126324,27.314
2023-05-09,461528,59670,176576,-116906,25.33
2023-05-16,471227,62198,174967,-112769,23.931
2023-05-23,477760,61835,180623,-118788,24.864
2023-05-30,475870,58062,185060,-126998,26.688
2023-06-06,489163,60299,179773,-119474,24.424
2023-06-13,465331,61483,174913,-113430,24.376
2023-06-20,451245,59558,143692,-84134,18.645
2023-06-27,359947,58494,110662,-52168,14.493
2023-07-03,359506,58733,112739,-54006,15.022
2023-07-11,362152,56419,108547,-52128,14.394
2023-07-18,374014,57448,111866,-54418,14.55
2023-07-25,401562,57860,98192,-40332,10.044
2023-08-01,402982,61350,111778,-50428,12.514
2023-08-08,431293,60234,115629,-55395,12.844
2023-08-15,465240,60574,126164,-65590,14.098
2023-08-22,481323,60716,131637,-70921,14.735
2023-08-29,423659,59987,139868,-79881,18.855
2023-09-05,446632,64165,142846,-78681,17.617
2023-09-12,469203,64934,149073,-84139,17.932
2023-09-19,482449,67543,164348,-96805,20.065
2023-09-26,486763,70888,167272,-96384,19.801
2023-10-03,510243,70744,169532,-98788,19.361
2023-10-10,509031,66207,170542,-104335,20.497
2023-10-17,515825,66870,171277,-104407,20.241
2023-10-24,520213,74376,166630,-92254,17.734
2023-10-31,534771,75345,176920,-101575,18.994
2023-11-07,525972,84141,176403,-92262,17.541
2023-11-14,514218,82599,171870,-89271,17.361
2023-11-21,521351,83635,191811,-108176,20.749
2023-11-28,459107,77865,197851,-119986,26.135
2023-12-05,468937,80227,176449,-96222,20.519
2023-12-12,409905,70548,140077,-69529,16.962
2023-12-19,412241,62858,127890,-65032,15.775
2023-12-26,412546,63779,123338,-59559,14.437
2024-01-02,416057,69795,130072,-60277,14.488
2024-01-09,427307,70307,128295,-57988,13.571
2024-01-16,458510,73485,142060,-68575,14.956
2024-01-23,467570,71222,135763,-64541,13.803
2024-01-30,459180,73140,137958,-64818,14.116
2024-02-06,469256,75116,141854,-66738,14.222
2024-02-13,448418,79331,135003,-55672,12.415
2024-02-20,455296,80868,149392,-68524,15.05
2024-02-27,414999,84963,141289,-56326,13.573
2024-03-05,451756,89296,154835,-65539,14.508
2024-03-12,451363,77445,156315,-78870,17.474
2024-03-19,477569,80721,161291,-80570,16.871
2024-03-26,465014,78028,170130,-92102,19.806
2024-04-02,471089,80217,172161,-91944,19.517
2024-04-09,457253,77901,164469,-86568,18.932
2024-04-16,449409,76466,172869,-96403,21.451
2024-04-23,453343,79159,155343,-76184,16.805
2024-04-30,423620,78382,126248,-47866,11.299
2024-05-07,448731,77781,120141,-42360,9.44
2024-05-14,492012,83400,111651,-28251,5.742
2024-05-21,515075,83816,108409,-24593,4.775
2024-05-28,516145,81665,107096,-25431,4.927
2024-06-04,517578,79043,110727,-31684,6.122
2024-06-11,489836,62817,107933,-45116,9.21
